fips,county,year,age,pop_female,pop_male,pop_total
6001,ALAMEDA,2017,0,9343,10293,19636
6001,ALAMEDA,2017,1,9388,10080,19468
6001,ALAMEDA,2017,2,9434,10004,19438
6001,ALAMEDA,2017,3,9664,9862,19526
6001,ALAMEDA,2017,4,9496,9993,19489
6001,ALAMEDA,2017,5,9249,9766,19015
6001,ALAMEDA,2017,6,9322,9842,19164
6001,ALAMEDA,2017,7,9443,9697,19140
6001,ALAMEDA,2017,8,9311,9842,19153
6001,ALAMEDA,2017,9,9610,10207,19817
6001,ALAMEDA,2017,10,9678,10319,19997
6001,ALAMEDA,2017,11,9334,10082,19416
6001,ALAMEDA,2017,12,9358,9930,19288
6001,ALAMEDA,2017,13,9605,9712,19317
6001,ALAMEDA,2017,14,9224,9539,18763
6001,ALAMEDA,2017,15,9168,9519,18687
6001,ALAMEDA,2017,16,9139,9563,18702
6001,ALAMEDA,2017,17,9190,9667,18857
6001,ALAMEDA,2017,18,12106,12804,24910
6001,ALAMEDA,2017,19,12191,12374,24565
6001,ALAMEDA,2017,20,12077,12434,24511
6001,ALAMEDA,2017,21,12268,12623,24891
6001,ALAMEDA,2017,22,11511,12447,23958
6001,ALAMEDA,2017,23,11719,12413,24132
6001,ALAMEDA,2017,24,12049,12697,24746
6001,ALAMEDA,2017,25,11699,11845,23544
6001,ALAMEDA,2017,26,11241,11085,22326
6001,ALAMEDA,2017,27,11839,11765,23604
6001,ALAMEDA,2017,28,11814,11789,23603
6001,ALAMEDA,2017,29,11897,11737,23634
6001,ALAMEDA,2017,30,12011,11913,23924
6001,ALAMEDA,2017,31,11763,11715,23478
6001,ALAMEDA,2017,32,12844,12432,25276
6001,ALAMEDA,2017,33,13036,12618,25654
6001,ALAMEDA,2017,34,12982,12733,25715
6001,ALAMEDA,2017,35,13107,12520,25627
6001,ALAMEDA,2017,36,12195,12036,24231
6001,ALAMEDA,2017,37,12639,12472,25111
6001,ALAMEDA,2017,38,11646,11111,22757
6001,ALAMEDA,2017,39,11610,11262,22872
6001,ALAMEDA,2017,40,11620,10868,22488
6001,ALAMEDA,2017,41,11342,11054,22396
6001,ALAMEDA,2017,42,11897,11718,23615
6001,ALAMEDA,2017,43,11459,11172,22631
6001,ALAMEDA,2017,44,11469,11182,22651
6001,ALAMEDA,2017,45,11608,11279,22887
6001,ALAMEDA,2017,46,11823,11687,23510
6001,ALAMEDA,2017,47,12458,12459,24917
6001,ALAMEDA,2017,48,11509,11488,22997
6001,ALAMEDA,2017,49,10803,10744,21547
6001,ALAMEDA,2017,50,10555,10567,21122
6001,ALAMEDA,2017,51,10703,10539,21242
6001,ALAMEDA,2017,52,11456,11193,22649
6001,ALAMEDA,2017,53,11513,10969,22482
6001,ALAMEDA,2017,54,11295,11096,22391
6001,ALAMEDA,2017,55,11192,10761,21953
6001,ALAMEDA,2017,56,11173,10502,21675
6001,ALAMEDA,2017,57,11224,11050,22274
6001,ALAMEDA,2017,58,10838,10312,21150
6001,ALAMEDA,2017,59,10737,10235,20972
6001,ALAMEDA,2017,60,10447,9903,20350
6001,ALAMEDA,2017,61,10164,9412,19576
6001,ALAMEDA,2017,62,10368,9525,19893
6001,ALAMEDA,2017,63,9638,8950,18588
6001,ALAMEDA,2017,64,9448,8369,17817
6001,ALAMEDA,2017,65,9147,8212,17359
6001,ALAMEDA,2017,66,8704,7320,16024
6001,ALAMEDA,2017,67,8746,7796,16542
6001,ALAMEDA,2017,68,8234,7264,15498
6001,ALAMEDA,2017,69,7981,6970,14951
6001,ALAMEDA,2017,70,7918,6810,14728
6001,ALAMEDA,2017,71,6426,5491,11917
6001,ALAMEDA,2017,72,6151,5251,11402
6001,ALAMEDA,2017,73,5517,4759,10276
6001,ALAMEDA,2017,74,5287,4433,9720
6001,ALAMEDA,2017,75,4975,3968,8943
6001,ALAMEDA,2017,76,4398,3524,7922
6001,ALAMEDA,2017,77,4363,3414,7777
6001,ALAMEDA,2017,78,3833,3026,6859
6001,ALAMEDA,2017,79,3680,2833,6513
6001,ALAMEDA,2017,80,3454,2497,5951
6001,ALAMEDA,2017,81,3270,2405,5675
6001,ALAMEDA,2017,82,3057,2137,5194
6001,ALAMEDA,2017,83,2731,1883,4614
6001,ALAMEDA,2017,84,2623,1828,4451
6001,ALAMEDA,2017,85,2606,1692,4298
6001,ALAMEDA,2017,86,2528,1499,4027
6001,ALAMEDA,2017,87,2322,1308,3630
6001,ALAMEDA,2017,88,2014,1125,3139
6001,ALAMEDA,2017,89,1822,984,2806
6001,ALAMEDA,2017,90,1771,973,2744
6001,ALAMEDA,2017,91,1583,742,2325
6001,ALAMEDA,2017,92,1143,556,1699
6001,ALAMEDA,2017,93,941,378,1319
6001,ALAMEDA,2017,94,719,339,1058
6001,ALAMEDA,2017,95,654,238,892
6001,ALAMEDA,2017,96,436,164,600
6001,ALAMEDA,2017,97,349,124,473
6001,ALAMEDA,2017,98,211,61,272
6001,ALAMEDA,2017,99,152,44,196
6001,ALAMEDA,2017,100,201,42,243
6001,ALAMEDA,2018,0,9327,10095,19422
6001,ALAMEDA,2018,1,9306,10258,19564
6001,ALAMEDA,2018,2,9388,10086,19474
6001,ALAMEDA,2018,3,9434,9998,19432
6001,ALAMEDA,2018,4,9665,9868,19533
6001,ALAMEDA,2018,5,9489,9976,19465
6001,ALAMEDA,2018,6,9243,9765,19008
6001,ALAMEDA,2018,7,9335,9838,19173
6001,ALAMEDA,2018,8,9428,9698,19126
6001,ALAMEDA,2018,9,9309,9832,19141
6001,ALAMEDA,2018,10,9606,10225,19831
6001,ALAMEDA,2018,11,9685,10305,19990
6001,ALAMEDA,2018,12,9326,10079,19405
6001,ALAMEDA,2018,13,9360,9945,19305
6001,ALAMEDA,2018,14,9604,9700,19304
6001,ALAMEDA,2018,15,9251,9548,18799
6001,ALAMEDA,2018,16,9161,9536,18697
6001,ALAMEDA,2018,17,9389,9787,19176
6001,ALAMEDA,2018,18,12382,12811,25193
6001,ALAMEDA,2018,19,11930,12638,24568
6001,ALAMEDA,2018,20,11917,12377,24294
6001,ALAMEDA,2018,21,12044,12390,24434
6001,ALAMEDA,2018,22,12390,12755,25145
6001,ALAMEDA,2018,23,11769,12498,24267
6001,ALAMEDA,2018,24,11906,12641,24547
6001,ALAMEDA,2018,25,11704,12325,24029
6001,ALAMEDA,2018,26,11496,11414,22910
6001,ALAMEDA,2018,27,11800,11619,23419
6001,ALAMEDA,2018,28,11997,11976,23973
6001,ALAMEDA,2018,29,12119,11988,24107
6001,ALAMEDA,2018,30,12283,12159,24442
6001,ALAMEDA,2018,31,11991,11923,23914
6001,ALAMEDA,2018,32,11780,11646,23426
6001,ALAMEDA,2018,33,12869,12452,25321
6001,ALAMEDA,2018,34,13156,12730,25886
6001,ALAMEDA,2018,35,12997,12738,25735
6001,ALAMEDA,2018,36,12790,12246,25036
6001,ALAMEDA,2018,37,12234,12073,24307
6001,ALAMEDA,2018,38,12683,12530,25213
6001,ALAMEDA,2018,39,11681,11173,22854
6001,ALAMEDA,2018,40,11690,11304,22994
6001,ALAMEDA,2018,41,11595,10798,22393
6001,ALAMEDA,2018,42,11307,11077,22384
6001,ALAMEDA,2018,43,11872,11655,23527
6001,ALAMEDA,2018,44,11454,11134,22588
6001,ALAMEDA,2018,45,11506,11223,22729
6001,ALAMEDA,2018,46,11549,11274,22823
6001,ALAMEDA,2018,47,11793,11647,23440
6001,ALAMEDA,2018,48,12452,12440,24892
6001,ALAMEDA,2018,49,11488,11468,22956
6001,ALAMEDA,2018,50,10804,10778,21582
6001,ALAMEDA,2018,51,10481,10455,20936
6001,ALAMEDA,2018,52,10709,10500,21209
6001,ALAMEDA,2018,53,11393,11108,22501
6001,ALAMEDA,2018,54,11475,10903,22378
6001,ALAMEDA,2018,55,11237,11054,22291
6001,ALAMEDA,2018,56,11132,10647,21779
6001,ALAMEDA,2018,57,11097,10389,21486
6001,ALAMEDA,2018,58,11157,10957,22114
6001,ALAMEDA,2018,59,10771,10214,20985
6001,ALAMEDA,2018,60,10665,10173,20838
6001,ALAMEDA,2018,61,10365,9749,20114
6001,ALAMEDA,2018,62,10101,9294,19395
6001,ALAMEDA,2018,63,10265,9413,19678
6001,ALAMEDA,2018,64,9589,8810,18399
6001,ALAMEDA,2018,65,9396,8238,17634
6001,ALAMEDA,2018,66,9041,8063,17104
6001,ALAMEDA,2018,67,8591,7229,15820
6001,ALAMEDA,2018,68,8650,7696,16346
6001,ALAMEDA,2018,69,8120,7133,15253
6001,ALAMEDA,2018,70,7918,6896,14814
6001,ALAMEDA,2018,71,7812,6671,14483
6001,ALAMEDA,2018,72,6363,5380,11743
6001,ALAMEDA,2018,73,6098,5146,11244
6001,ALAMEDA,2018,74,5451,4673,10124
6001,ALAMEDA,2018,75,5264,4352,9616
6001,ALAMEDA,2018,76,4811,3843,8654
6001,ALAMEDA,2018,77,4287,3409,7696
6001,ALAMEDA,2018,78,4241,3264,7505
6001,ALAMEDA,2018,79,3730,2966,6696
6001,ALAMEDA,2018,80,3668,2748,6416
6001,ALAMEDA,2018,81,3306,2378,5684
6001,ALAMEDA,2018,82,3128,2243,5371
6001,ALAMEDA,2018,83,2917,1995,4912
6001,ALAMEDA,2018,84,2607,1772,4379
6001,ALAMEDA,2018,85,2676,1777,4453
6001,ALAMEDA,2018,86,2457,1523,3980
6001,ALAMEDA,2018,87,2322,1378,3700
6001,ALAMEDA,2018,88,2158,1167,3325
6001,ALAMEDA,2018,89,1868,1040,2908
6001,ALAMEDA,2018,90,1682,879,2561
6001,ALAMEDA,2018,91,1488,801,2289
6001,ALAMEDA,2018,92,1366,614,1980
6001,ALAMEDA,2018,93,995,434,1429
6001,ALAMEDA,2018,94,799,329,1128
6001,ALAMEDA,2018,95,611,274,885
6001,ALAMEDA,2018,96,494,162,656
6001,ALAMEDA,2018,97,332,124,456
6001,ALAMEDA,2018,98,251,84,335
6001,ALAMEDA,2018,99,146,40,186
6001,ALAMEDA,2018,100,235,57,292
6001,ALAMEDA,2019,0,9232,10123,19355
6001,ALAMEDA,2019,1,9287,10051,19338
6001,ALAMEDA,2019,2,9304,10265,19569
6001,ALAMEDA,2019,3,9389,10078,19467
6001,ALAMEDA,2019,4,9437,10007,19444
6001,ALAMEDA,2019,5,9660,9850,19510
6001,ALAMEDA,2019,6,9482,9976,19458
6001,ALAMEDA,2019,7,9256,9765,19021
6001,ALAMEDA,2019,8,9321,9840,19161
6001,ALAMEDA,2019,9,9426,9687,19113
6001,ALAMEDA,2019,10,9305,9849,19154
6001,ALAMEDA,2019,11,9610,10210,19820
6001,ALAMEDA,2019,12,9678,10305,19983
6001,ALAMEDA,2019,13,9329,10095,19424
6001,ALAMEDA,2019,14,9360,9932,19292
6001,ALAMEDA,2019,15,9633,9709,19342
6001,ALAMEDA,2019,16,9255,9558,18813
6001,ALAMEDA,2019,17,9411,9761,19172
6001,ALAMEDA,2019,18,12582,12939,25521
6001,ALAMEDA,2019,19,12218,12639,24857
6001,ALAMEDA,2019,20,11651,12642,24293
6001,ALAMEDA,2019,21,11896,12332,24228
6001,ALAMEDA,2019,22,12183,12497,24680
6001,ALAMEDA,2019,23,12663,12816,25479
6001,ALAMEDA,2019,24,11987,12707,24694
6001,ALAMEDA,2019,25,11572,12249,23821
6001,ALAMEDA,2019,26,11504,11944,23448
6001,ALAMEDA,2019,27,12069,11950,24019
6001,ALAMEDA,2019,28,11963,11811,23774
6001,ALAMEDA,2019,29,12252,12157,24409
6001,ALAMEDA,2019,30,12517,12423,24940
6001,ALAMEDA,2019,31,12240,12185,24425
6001,ALAMEDA,2019,32,12026,11858,23884
6001,ALAMEDA,2019,33,11811,11645,23456
6001,ALAMEDA,2019,34,12987,12573,25560
6001,ALAMEDA,2019,35,13160,12731,25891
6001,ALAMEDA,2019,36,12691,12455,25146
6001,ALAMEDA,2019,37,12837,12293,25130
6001,ALAMEDA,2019,38,12289,12140,24429
6001,ALAMEDA,2019,39,12707,12589,25296
6001,ALAMEDA,2019,40,11771,11205,22976
6001,ALAMEDA,2019,41,11666,11226,22892
6001,ALAMEDA,2019,42,11557,10819,22376
6001,ALAMEDA,2019,43,11284,11016,22300
6001,ALAMEDA,2019,44,11869,11619,23488
6001,ALAMEDA,2019,45,11489,11177,22666
6001,ALAMEDA,2019,46,11442,11216,22658
6001,ALAMEDA,2019,47,11529,11226,22755
6001,ALAMEDA,2019,48,11793,11626,23419
6001,ALAMEDA,2019,49,12435,12414,24849
6001,ALAMEDA,2019,50,11474,11506,22980
6001,ALAMEDA,2019,51,10717,10680,21397
6001,ALAMEDA,2019,52,10489,10403,20892
6001,ALAMEDA,2019,53,10653,10425,21078
6001,ALAMEDA,2019,54,11353,11053,22406
6001,ALAMEDA,2019,55,11421,10865,22286
6001,ALAMEDA,2019,56,11174,10952,22126
6001,ALAMEDA,2019,57,11078,10544,21622
6001,ALAMEDA,2019,58,11031,10299,21330
6001,ALAMEDA,2019,59,11090,10853,21943
6001,ALAMEDA,2019,60,10686,10149,20835
6001,ALAMEDA,2019,61,10583,10033,20616
6001,ALAMEDA,2019,62,10292,9635,19927
6001,ALAMEDA,2019,63,9999,9190,19189
6001,ALAMEDA,2019,64,10211,9284,19495
6001,ALAMEDA,2019,65,9551,8703,18254
6001,ALAMEDA,2019,66,9312,8092,17404
6001,ALAMEDA,2019,67,8923,7981,16904
6001,ALAMEDA,2019,68,8495,7118,15613
6001,ALAMEDA,2019,69,8543,7574,16117
6001,ALAMEDA,2019,70,8057,7066,15123
6001,ALAMEDA,2019,71,7824,6767,14591
6001,ALAMEDA,2019,72,7710,6552,14262
6001,ALAMEDA,2019,73,6292,5269,11561
6001,ALAMEDA,2019,74,6013,5049,11062
6001,ALAMEDA,2019,75,5442,4594,10036
6001,ALAMEDA,2019,76,5099,4229,9328
6001,ALAMEDA,2019,77,4689,3733,8422
6001,ALAMEDA,2019,78,4174,3290,7464
6001,ALAMEDA,2019,79,4129,3179,7308
6001,ALAMEDA,2019,80,3723,2875,6598
6001,ALAMEDA,2019,81,3520,2603,6123
6001,ALAMEDA,2019,82,3174,2240,5414
6001,ALAMEDA,2019,83,3006,2117,5123
6001,ALAMEDA,2019,84,2797,1887,4684
6001,ALAMEDA,2019,85,2662,1722,4384
6001,ALAMEDA,2019,86,2518,1628,4146
6001,ALAMEDA,2019,87,2271,1404,3675
6001,ALAMEDA,2019,88,2163,1261,3424
6001,ALAMEDA,2019,89,1993,1068,3061
6001,ALAMEDA,2019,90,1748,942,2690
6001,ALAMEDA,2019,91,1417,709,2126
6001,ALAMEDA,2019,92,1268,657,1925
6001,ALAMEDA,2019,93,1166,487,1653
6001,ALAMEDA,2019,94,838,360,1198
6001,ALAMEDA,2019,95,670,267,937
6001,ALAMEDA,2019,96,446,205,651
6001,ALAMEDA,2019,97,389,122,511
6001,ALAMEDA,2019,98,266,90,356
6001,ALAMEDA,2019,99,181,59,240
6001,ALAMEDA,2019,100,253,68,321
6003,ALPINE,2017,0,4,1,5
6003,ALPINE,2017,1,2,2,4
6003,ALPINE,2017,2,3,2,5
6003,ALPINE,2017,3,3,2,5
6003,ALPINE,2017,4,2,5,7
6003,ALPINE,2017,5,0,4,4
6003,ALPINE,2017,6,2,1,3
6003,ALPINE,2017,7,1,5,6
6003,ALPINE,2017,8,3,8,11
6003,ALPINE,2017,9,11,7,18
6003,ALPINE,2017,10,8,9,17
6003,ALPINE,2017,11,4,13,17
6003,ALPINE,2017,12,9,3,12
6003,ALPINE,2017,13,9,8,17
6003,ALPINE,2017,14,10,8,18
6003,ALPINE,2017,15,8,10,18
6003,ALPINE,2017,16,7,8,15
6003,ALPINE,2017,17,10,6,16
6003,ALPINE,2017,18,11,3,14
6003,ALPINE,2017,19,8,4,12
6003,ALPINE,2017,20,3,9,12
6003,ALPINE,2017,21,13,6,19
6003,ALPINE,2017,22,9,6,15
6003,ALPINE,2017,23,3,4,7
6003,ALPINE,2017,24,11,5,16
6003,ALPINE,2017,25,4,7,11
6003,ALPINE,2017,26,3,7,10
6003,ALPINE,2017,27,4,4,8
6003,ALPINE,2017,28,1,5,6
6003,ALPINE,2017,29,5,6,11
6003,ALPINE,2017,30,3,6,9
6003,ALPINE,2017,31,2,8,10
6003,ALPINE,2017,32,5,4,9
6003,ALPINE,2017,33,9,3,12
6003,ALPINE,2017,34,4,3,7
6003,ALPINE,2017,35,5,4,9
6003,ALPINE,2017,36,5,6,11
6003,ALPINE,2017,37,5,5,10
6003,ALPINE,2017,38,5,3,8
6003,ALPINE,2017,39,4,5,9
6003,ALPINE,2017,40,6,2,8
6003,ALPINE,2017,41,7,6,13
6003,ALPINE,2017,42,2,4,6
6003,ALPINE,2017,43,4,10,14
6003,ALPINE,2017,44,6,7,13
6003,ALPINE,2017,45,1,3,4
6003,ALPINE,2017,46,7,10,17
6003,ALPINE,2017,47,4,8,12
6003,ALPINE,2017,48,6,7,13
6003,ALPINE,2017,49,6,7,13
6003,ALPINE,2017,50,13,11,24
6003,ALPINE,2017,51,10,7,17
6003,ALPINE,2017,52,8,5,13
6003,ALPINE,2017,53,10,10,20
6003,ALPINE,2017,54,11,9,20
6003,ALPINE,2017,55,6,14,20
6003,ALPINE,2017,56,11,11,22
6003,ALPINE,2017,57,10,7,17
6003,ALPINE,2017,58,10,11,21
6003,ALPINE,2017,59,12,13,25
6003,ALPINE,2017,60,15,13,28
6003,ALPINE,2017,61,8,7,15
6003,ALPINE,2017,62,6,21,27
6003,ALPINE,2017,63,12,15,27
6003,ALPINE,2017,64,12,10,22
6003,ALPINE,2017,65,9,14,23
6003,ALPINE,2017,66,11,9,20
6003,ALPINE,2017,67,8,10,18
6003,ALPINE,2017,68,11,9,20
6003,ALPINE,2017,69,12,11,23
6003,ALPINE,2017,70,17,12,29
6003,ALPINE,2017,71,3,8,11
6003,ALPINE,2017,72,8,9,17
6003,ALPINE,2017,73,7,4,11
6003,ALPINE,2017,74,5,8,13
6003,ALPINE,2017,75,4,3,7
6003,ALPINE,2017,76,5,5,10
6003,ALPINE,2017,77,4,2,6
6003,ALPINE,2017,79,2,6,8
6003,ALPINE,2017,80,6,2,8
6003,ALPINE,2017,81,7,6,13
6003,ALPINE,2017,82,4,4,8
6003,ALPINE,2017,83,0,4,4
6003,ALPINE,2017,84,3,4,7
6003,ALPINE,2017,85,2,2,4
6003,ALPINE,2017,86,1,4,5
6003,ALPINE,2017,87,0,5,5
6003,ALPINE,2017,88,2,0,2
6003,ALPINE,2017,89,2,0,2
6003,ALPINE,2017,90,1,1,2
6003,ALPINE,2017,91,1,0,1
6003,ALPINE,2017,92,1,0,1
6003,ALPINE,2017,98,0,1,1
6003,ALPINE,2018,0,4,1,5
6003,ALPINE,2018,1,4,1,5
6003,ALPINE,2018,2,2,2,4
6003,ALPINE,2018,3,3,2,5
6003,ALPINE,2018,4,3,2,5
6003,ALPINE,2018,5,2,5,7
6003,ALPINE,2018,6,0,4,4
6003,ALPINE,2018,7,2,1,3
6003,ALPINE,2018,8,1,5,6
6003,ALPINE,2018,9,3,8,11
6003,ALPINE,2018,10,11,7,18
6003,ALPINE,2018,11,8,9,17
6003,ALPINE,2018,12,4,13,17
6003,ALPINE,2018,13,9,3,12
6003,ALPINE,2018,14,9,8,17
6003,ALPINE,2018,15,10,8,18
6003,ALPINE,2018,16,8,11,19
6003,ALPINE,2018,17,7,8,15
6003,ALPINE,2018,18,9,6,15
6003,ALPINE,2018,19,11,3,14
6003,ALPINE,2018,20,8,4,12
6003,ALPINE,2018,21,4,9,13
6003,ALPINE,2018,22,12,6,18
6003,ALPINE,2018,23,9,6,15
6003,ALPINE,2018,24,4,5,9
6003,ALPINE,2018,25,10,4,14
6003,ALPINE,2018,26,5,6,11
6003,ALPINE,2018,27,2,7,9
6003,ALPINE,2018,28,4,5,9
6003,ALPINE,2018,29,1,6,7
6003,ALPINE,2018,30,5,4,9
6003,ALPINE,2018,31,3,6,9
6003,ALPINE,2018,32,2,9,11
6003,ALPINE,2018,33,5,3,8
6003,ALPINE,2018,34,9,3,12
6003,ALPINE,2018,35,4,3,7
6003,ALPINE,2018,36,5,5,10
6003,ALPINE,2018,37,5,6,11
6003,ALPINE,2018,38,5,4,9
6003,ALPINE,2018,39,5,3,8
6003,ALPINE,2018,40,4,6,10
6003,ALPINE,2018,41,6,2,8
6003,ALPINE,2018,42,7,5,12
6003,ALPINE,2018,43,2,6,8
6003,ALPINE,2018,44,4,8,12
6003,ALPINE,2018,45,6,7,13
6003,ALPINE,2018,46,1,3,4
6003,ALPINE,2018,47,7,11,18
6003,ALPINE,2018,48,4,8,12
6003,ALPINE,2018,49,6,7,13
6003,ALPINE,2018,50,6,7,13
6003,ALPINE,2018,51,13,11,24
6003,ALPINE,2018,52,10,7,17
6003,ALPINE,2018,53,8,5,13
6003,ALPINE,2018,54,10,10,20
6003,ALPINE,2018,55,11,9,20
6003,ALPINE,2018,56,7,14,21
6003,ALPINE,2018,57,10,12,22
6003,ALPINE,2018,58,10,7,17
6003,ALPINE,2018,59,10,12,22
6003,ALPINE,2018,60,12,13,25
6003,ALPINE,2018,61,15,13,28
6003,ALPINE,2018,62,8,7,15
6003,ALPINE,2018,63,7,21,28
6003,ALPINE,2018,64,12,15,27
6003,ALPINE,2018,65,12,10,22
6003,ALPINE,2018,66,9,13,22
6003,ALPINE,2018,67,11,9,20
6003,ALPINE,2018,68,8,10,18
6003,ALPINE,2018,69,11,9,20
6003,ALPINE,2018,70,12,11,23
6003,ALPINE,2018,71,17,12,29
6003,ALPINE,2018,72,2,8,10
6003,ALPINE,2018,73,8,9,17
6003,ALPINE,2018,74,7,4,11
6003,ALPINE,2018,75,5,8,13
6003,ALPINE,2018,76,4,2,6
6003,ALPINE,2018,77,5,5,10
6003,ALPINE,2018,78,4,2,6
6003,ALPINE,2018,80,2,5,7
6003,ALPINE,2018,81,6,2,8
6003,ALPINE,2018,82,5,5,10
6003,ALPINE,2018,83,4,4,8
6003,ALPINE,2018,84,0,4,4
6003,ALPINE,2018,85,3,2,5
6003,ALPINE,2018,86,1,2,3
6003,ALPINE,2018,87,1,3,4
6003,ALPINE,2018,88,0,5,5
6003,ALPINE,2018,89,2,0,2
6003,ALPINE,2018,90,2,0,2
6003,ALPINE,2018,92,1,0,1
6003,ALPINE,2018,93,1,0,1
6003,ALPINE,2018,99,0,1,1
6003,ALPINE,2019,0,2,3,5
6003,ALPINE,2019,1,4,1,5
6003,ALPINE,2019,2,4,1,5
6003,ALPINE,2019,3,2,2,4
6003,ALPINE,2019,4,3,2,5
6003,ALPINE,2019,5,3,2,5
6003,ALPINE,2019,6,2,5,7
6003,ALPINE,2019,7,0,4,4
6003,ALPINE,2019,8,2,1,3
6003,ALPINE,2019,9,1,5,6
6003,ALPINE,2019,10,3,8,11
6003,ALPINE,2019,11,11,7,18
6003,ALPINE,2019,12,8,9,17
6003,ALPINE,2019,13,4,13,17
6003,ALPINE,2019,14,9,3,12
6003,ALPINE,2019,15,9,8,17
6003,ALPINE,2019,16,10,9,19
6003,ALPINE,2019,17,8,10,18
6003,ALPINE,2019,18,7,8,15
6003,ALPINE,2019,19,9,6,15
6003,ALPINE,2019,20,11,3,14
6003,ALPINE,2019,21,9,4,13
6003,ALPINE,2019,22,3,9,12
6003,ALPINE,2019,23,12,6,18
6003,ALPINE,2019,24,10,7,17
6003,ALPINE,2019,25,3,4,7
6003,ALPINE,2019,26,11,3,14
6003,ALPINE,2019,27,4,6,10
6003,ALPINE,2019,28,2,8,10
6003,ALPINE,2019,29,4,6,10
6003,ALPINE,2019,30,1,4,5
6003,ALPINE,2019,31,5,4,9
6003,ALPINE,2019,32,3,7,10
6003,ALPINE,2019,33,2,8,10
6003,ALPINE,2019,34,5,3,8
6003,ALPINE,2019,35,9,3,12
6003,ALPINE,2019,36,4,4,8
6003,ALPINE,2019,37,5,5,10
6003,ALPINE,2019,38,5,5,10
6003,ALPINE,2019,39,4,4,8
6003,ALPINE,2019,40,6,3,9
6003,ALPINE,2019,41,3,6,9
6003,ALPINE,2019,42,6,2,8
6003,ALPINE,2019,43,7,7,14
6003,ALPINE,2019,44,2,4,6
6003,ALPINE,2019,45,4,8,12
6003,ALPINE,2019,46,6,7,13
6003,ALPINE,2019,47,1,4,5
6003,ALPINE,2019,48,7,11,18
6003,ALPINE,2019,49,5,7,12
6003,ALPINE,2019,50,6,7,13
6003,ALPINE,2019,51,6,7,13
6003,ALPINE,2019,52,13,11,24
6003,ALPINE,2019,53,10,7,17
6003,ALPINE,2019,54,8,5,13
6003,ALPINE,2019,55,10,10,20
6003,ALPINE,2019,56,11,9,20
6003,ALPINE,2019,57,9,14,23
6003,ALPINE,2019,58,10,12,22
6003,ALPINE,2019,59,10,7,17
6003,ALPINE,2019,60,10,12,22
6003,ALPINE,2019,61,12,12,24
6003,ALPINE,2019,62,16,13,29
6003,ALPINE,2019,63,8,8,16
6003,ALPINE,2019,64,7,21,28
6003,ALPINE,2019,65,12,14,26
6003,ALPINE,2019,66,11,10,21
6003,ALPINE,2019,67,9,13,22
6003,ALPINE,2019,68,11,9,20
6003,ALPINE,2019,69,7,10,17
6003,ALPINE,2019,70,10,9,19
6003,ALPINE,2019,71,12,11,23
6003,ALPINE,2019,72,17,10,27
6003,ALPINE,2019,73,2,8,10
6003,ALPINE,2019,74,7,9,16
6003,ALPINE,2019,75,7,4,11
6003,ALPINE,2019,76,5,8,13
6003,ALPINE,2019,77,4,2,6
6003,ALPINE,2019,78,5,5,10
6003,ALPINE,2019,79,4,2,6
6003,ALPINE,2019,81,2,5,7
6003,ALPINE,2019,82,6,1,7
6003,ALPINE,2019,83,4,5,9
6003,ALPINE,2019,84,4,4,8
6003,ALPINE,2019,85,0,3,3
6003,ALPINE,2019,86,3,2,5
6003,ALPINE,2019,87,1,2,3
6003,ALPINE,2019,88,1,3,4
6003,ALPINE,2019,89,0,5,5
6003,ALPINE,2019,90,2,0,2
6003,ALPINE,2019,91,2,0,2
6003,ALPINE,2019,93,1,0,1
6003,ALPINE,2019,94,1,0,1
6003,ALPINE,2019,100,0,1,1
6005,AMADOR,2017,0,131,173,304
6005,AMADOR,2017,1,139,161,300
6005,AMADOR,2017,2,156,148,304
6005,AMADOR,2017,3,147,133,280
6005,AMADOR,2017,4,99,151,250
6005,AMADOR,2017,5,136,137,273
6005,AMADOR,2017,6,113,159,272
6005,AMADOR,2017,7,155,154,309
6005,AMADOR,2017,8,148,146,294
6005,AMADOR,2017,9,147,125,272
6005,AMADOR,2017,10,168,150,318
6005,AMADOR,2017,11,137,158,295
6005,AMADOR,2017,12,183,158,341
6005,AMADOR,2017,13,168,181,349
6005,AMADOR,2017,14,169,168,337
6005,AMADOR,2017,15,143,184,327
6005,AMADOR,2017,16,186,191,377
6005,AMADOR,2017,17,190,215,405
6005,AMADOR,2017,18,195,257,452
6005,AMADOR,2017,19,195,266,461
6005,AMADOR,2017,20,194,265,459
6005,AMADOR,2017,21,204,244,448
6005,AMADOR,2017,22,181,229,410
6005,AMADOR,2017,23,206,248,454
6005,AMADOR,2017,24,254,268,522
6005,AMADOR,2017,25,169,278,447
6005,AMADOR,2017,26,156,257,413
6005,AMADOR,2017,27,147,257,404
6005,AMADOR,2017,28,146,201,347
6005,AMADOR,2017,29,104,199,303
6005,AMADOR,2017,30,118,219,337
6005,AMADOR,2017,31,141,256,397
6005,AMADOR,2017,32,119,210,329
6005,AMADOR,2017,33,152,199,351
6005,AMADOR,2017,34,122,192,314
6005,AMADOR,2017,35,156,240,396
6005,AMADOR,2017,36,156,203,359
6005,AMADOR,2017,37,150,241,391
6005,AMADOR,2017,38,130,209,339
6005,AMADOR,2017,39,135,257,392
6005,AMADOR,2017,40,149,273,422
6005,AMADOR,2017,41,138,247,385
6005,AMADOR,2017,42,134,237,371
6005,AMADOR,2017,43,141,237,378
6005,AMADOR,2017,44,171,242,413
6005,AMADOR,2017,45,154,246,400
6005,AMADOR,2017,46,172,271,443
6005,AMADOR,2017,47,168,349,517
6005,AMADOR,2017,48,192,280,472
6005,AMADOR,2017,49,197,281,478
6005,AMADOR,2017,50,174,265,439
6005,AMADOR,2017,51,174,291,465
6005,AMADOR,2017,52,234,249,483
6005,AMADOR,2017,53,225,337,562
6005,AMADOR,2017,54,272,312,584
6005,AMADOR,2017,55,249,312,561
6005,AMADOR,2017,56,285,300,585
6005,AMADOR,2017,57,302,327,629
6005,AMADOR,2017,58,299,310,609
6005,AMADOR,2017,59,309,325,634
6005,AMADOR,2017,60,266,284,550
6005,AMADOR,2017,61,293,248,541
6005,AMADOR,2017,62,351,335,686
6005,AMADOR,2017,63,293,313,606
6005,AMADOR,2017,64,366,316,682
6005,AMADOR,2017,65,331,285,616
6005,AMADOR,2017,66,331,279,610
6005,AMADOR,2017,67,343,306,649
6005,AMADOR,2017,68,326,317,643
6005,AMADOR,2017,69,312,321,633
6005,AMADOR,2017,70,378,311,689
6005,AMADOR,2017,71,295,254,549
6005,AMADOR,2017,72,273,240,513
6005,AMADOR,2017,73,262,238,500
6005,AMADOR,2017,74,213,218,431
6005,AMADOR,2017,75,207,204,411
6005,AMADOR,2017,76,183,172,355
6005,AMADOR,2017,77,166,175,341
6005,AMADOR,2017,78,182,146,328
6005,AMADOR,2017,79,179,183,362
6005,AMADOR,2017,80,141,129,270
6005,AMADOR,2017,81,125,133,258
6005,AMADOR,2017,82,123,108,231
6005,AMADOR,2017,83,122,93,215
6005,AMADOR,2017,84,104,99,203
6005,AMADOR,2017,85,81,71,152
6005,AMADOR,2017,86,88,80,168
6005,AMADOR,2017,87,74,62,136
6005,AMADOR,2017,88,91,66,157
6005,AMADOR,2017,89,77,58,135
6005,AMADOR,2017,90,74,55,129
6005,AMADOR,2017,91,54,47,101
6005,AMADOR,2017,92,45,24,69
6005,AMADOR,2017,93,29,16,45
6005,AMADOR,2017,94,23,15,38
6005,AMADOR,2017,95,33,21,54
6005,AMADOR,2017,96,10,6,16
6005,AMADOR,2017,97,4,1,5
6005,AMADOR,2017,98,8,9,17
6005,AMADOR,2017,99,4,0,4
6005,AMADOR,2017,100,4,3,7
6005,AMADOR,2018,0,147,165,312
6005,AMADOR,2018,1,131,174,305
6005,AMADOR,2018,2,141,160,301
6005,AMADOR,2018,3,156,149,305
6005,AMADOR,2018,4,147,133,280
6005,AMADOR,2018,5,101,151,252
6005,AMADOR,2018,6,137,141,278
6005,AMADOR,2018,7,112,162,274
6005,AMADOR,2018,8,156,160,316
6005,AMADOR,2018,9,148,148,296
6005,AMADOR,2018,10,149,131,280
6005,AMADOR,2018,11,168,151,319
6005,AMADOR,2018,12,137,158,295
6005,AMADOR,2018,13,183,158,341
6005,AMADOR,2018,14,169,181,350
6005,AMADOR,2018,15,169,187,356
6005,AMADOR,2018,16,145,187,332
6005,AMADOR,2018,17,183,228,411
6005,AMADOR,2018,18,199,236,435
6005,AMADOR,2018,19,195,261,456
6005,AMADOR,2018,20,200,254,454
6005,AMADOR,2018,21,198,243,441
6005,AMADOR,2018,22,196,239,435
6005,AMADOR,2018,23,183,241,424
6005,AMADOR,2018,24,206,238,444
6005,AMADOR,2018,25,253,281,534
6005,AMADOR,2018,26,169,284,453
6005,AMADOR,2018,27,156,287,443
6005,AMADOR,2018,28,149,243,392
6005,AMADOR,2018,29,143,208,351
6005,AMADOR,2018,30,105,200,305
6005,AMADOR,2018,31,120,229,349
6005,AMADOR,2018,32,140,238,378
6005,AMADOR,2018,33,118,219,337
6005,AMADOR,2018,34,151,205,356
6005,AMADOR,2018,35,122,210,332
6005,AMADOR,2018,36,157,205,362
6005,AMADOR,2018,37,155,218,373
6005,AMADOR,2018,38,150,235,385
6005,AMADOR,2018,39,132,243,375
6005,AMADOR,2018,40,136,267,403
6005,AMADOR,2018,41,150,260,410
6005,AMADOR,2018,42,137,241,378
6005,AMADOR,2018,43,137,233,370
6005,AMADOR,2018,44,141,232,373
6005,AMADOR,2018,45,167,247,414
6005,AMADOR,2018,46,156,266,422
6005,AMADOR,2018,47,176,305,481
6005,AMADOR,2018,48,170,312,482
6005,AMADOR,2018,49,190,274,464
6005,AMADOR,2018,50,202,267,469
6005,AMADOR,2018,51,170,265,435
6005,AMADOR,2018,52,172,273,445
6005,AMADOR,2018,53,237,267,504
6005,AMADOR,2018,54,218,326,544
6005,AMADOR,2018,55,270,277,547
6005,AMADOR,2018,56,258,319,577
6005,AMADOR,2018,57,288,311,599
6005,AMADOR,2018,58,317,317,634
6005,AMADOR,2018,59,298,317,615
6005,AMADOR,2018,60,309,325,634
6005,AMADOR,2018,61,276,278,554
6005,AMADOR,2018,62,300,260,560
6005,AMADOR,2018,63,360,326,686
6005,AMADOR,2018,64,293,317,610
6005,AMADOR,2018,65,361,295,656
6005,AMADOR,2018,66,329,292,621
6005,AMADOR,2018,67,327,266,593
6005,AMADOR,2018,68,341,302,643
6005,AMADOR,2018,69,325,318,643
6005,AMADOR,2018,70,308,317,625
6005,AMADOR,2018,71,370,307,677
6005,AMADOR,2018,72,294,243,537
6005,AMADOR,2018,73,273,241,514
6005,AMADOR,2018,74,256,233,489
6005,AMADOR,2018,75,208,212,420
6005,AMADOR,2018,76,207,202,409
6005,AMADOR,2018,77,182,168,350
6005,AMADOR,2018,78,158,164,322
6005,AMADOR,2018,79,178,149,327
6005,AMADOR,2018,80,176,173,349
6005,AMADOR,2018,81,134,122,256
6005,AMADOR,2018,82,121,124,245
6005,AMADOR,2018,83,118,98,216
6005,AMADOR,2018,84,119,92,211
6005,AMADOR,2018,85,103,94,197
6005,AMADOR,2018,86,83,64,147
6005,AMADOR,2018,87,77,69,146
6005,AMADOR,2018,88,64,62,126
6005,AMADOR,2018,89,90,54,144
6005,AMADOR,2018,90,70,50,120
6005,AMADOR,2018,91,68,49,117
6005,AMADOR,2018,92,38,38,76
6005,AMADOR,2018,93,38,21,59
6005,AMADOR,2018,94,23,16,39
6005,AMADOR,2018,95,16,10,26
6005,AMADOR,2018,96,22,15,37
6005,AMADOR,2018,97,8,5,13
6005,AMADOR,2018,98,2,1,3
6005,AMADOR,2018,99,6,6,12
6005,AMADOR,2018,100,7,2,9
6005,AMADOR,2019,0,141,173,314
6005,AMADOR,2019,1,147,166,313
6005,AMADOR,2019,2,133,175,308
6005,AMADOR,2019,3,140,162,302
6005,AMADOR,2019,4,156,149,305
6005,AMADOR,2019,5,148,133,281
6005,AMADOR,2019,6,104,158,262
6005,AMADOR,2019,7,137,143,280
6005,AMADOR,2019,8,114,167,281
6005,AMADOR,2019,9,156,160,316
6005,AMADOR,2019,10,151,151,302
6005,AMADOR,2019,11,149,132,281
6005,AMADOR,2019,12,168,152,320
6005,AMADOR,2019,13,137,158,295
6005,AMADOR,2019,14,183,158,341
6005,AMADOR,2019,15,169,201,370
6005,AMADOR,2019,16,172,192,364
6005,AMADOR,2019,17,145,216,361
6005,AMADOR,2019,18,193,248,441
6005,AMADOR,2019,19,199,244,443
6005,AMADOR,2019,20,199,252,451
6005,AMADOR,2019,21,204,231,435
6005,AMADOR,2019,22,193,238,431
6005,AMADOR,2019,23,198,250,448
6005,AMADOR,2019,24,184,229,413
6005,AMADOR,2019,25,206,251,457
6005,AMADOR,2019,26,252,288,540
6005,AMADOR,2019,27,170,314,484
6005,AMADOR,2019,28,163,273,436
6005,AMADOR,2019,29,146,250,396
6005,AMADOR,2019,30,145,207,352
6005,AMADOR,2019,31,107,210,317
6005,AMADOR,2019,32,119,210,329
6005,AMADOR,2019,33,139,247,386
6005,AMADOR,2019,34,117,226,343
6005,AMADOR,2019,35,151,222,373
6005,AMADOR,2019,36,122,174,296
6005,AMADOR,2019,37,156,220,376
6005,AMADOR,2019,38,155,214,369
6005,AMADOR,2019,39,151,270,421
6005,AMADOR,2019,40,133,255,388
6005,AMADOR,2019,41,137,256,393
6005,AMADOR,2019,42,149,256,405
6005,AMADOR,2019,43,140,238,378
6005,AMADOR,2019,44,136,226,362
6005,AMADOR,2019,45,140,237,377
6005,AMADOR,2019,46,167,270,437
6005,AMADOR,2019,47,160,299,459
6005,AMADOR,2019,48,178,271,449
6005,AMADOR,2019,49,169,305,474
6005,AMADOR,2019,50,198,260,458
6005,AMADOR,2019,51,198,266,464
6005,AMADOR,2019,52,164,251,415
6005,AMADOR,2019,53,176,292,468
6005,AMADOR,2019,54,231,256,487
6005,AMADOR,2019,55,217,292,509
6005,AMADOR,2019,56,282,291,573
6005,AMADOR,2019,57,259,331,590
6005,AMADOR,2019,58,299,302,601
6005,AMADOR,2019,59,315,326,641
6005,AMADOR,2019,60,301,314,615
6005,AMADOR,2019,61,315,315,630
6005,AMADOR,2019,62,282,291,573
6005,AMADOR,2019,63,309,255,564
6005,AMADOR,2019,64,359,330,689
6005,AMADOR,2019,65,290,304,594
6005,AMADOR,2019,66,361,305,666
6005,AMADOR,2019,67,331,278,609
6005,AMADOR,2019,68,329,263,592
6005,AMADOR,2019,69,337,305,642
6005,AMADOR,2019,70,323,312,635
6005,AMADOR,2019,71,300,315,615
6005,AMADOR,2019,72,365,291,656
6005,AMADOR,2019,73,287,243,530
6005,AMADOR,2019,74,268,239,507
6005,AMADOR,2019,75,255,223,478
6005,AMADOR,2019,76,203,207,410
6005,AMADOR,2019,77,208,197,405
6005,AMADOR,2019,78,177,159,336
6005,AMADOR,2019,79,157,158,315
6005,AMADOR,2019,80,175,147,322
6005,AMADOR,2019,81,165,166,331
6005,AMADOR,2019,82,127,114,241
6005,AMADOR,2019,83,117,119,236
6005,AMADOR,2019,84,117,96,213
6005,AMADOR,2019,85,113,89,202
6005,AMADOR,2019,86,99,83,182
6005,AMADOR,2019,87,73,52,125
6005,AMADOR,2019,88,67,70,137
6005,AMADOR,2019,89,66,53,119
6005,AMADOR,2019,90,82,47,129
6005,AMADOR,2019,91,66,38,104
6005,AMADOR,2019,92,45,42,87
6005,AMADOR,2019,93,36,32,68
6005,AMADOR,2019,94,32,17,49
6005,AMADOR,2019,95,19,14,33
6005,AMADOR,2019,96,12,6,18
6005,AMADOR,2019,97,17,10,27
6005,AMADOR,2019,98,4,4,8
6005,AMADOR,2019,99,2,0,2
6005,AMADOR,2019,100,7,5,12
6007,BUTTE,2017,0,1152,1290,2442
6007,BUTTE,2017,1,1198,1217,2415
6007,BUTTE,2017,2,1209,1258,2467
6007,BUTTE,2017,3,1225,1310,2535
6007,BUTTE,2017,4,1188,1164,2352
6007,BUTTE,2017,5,1206,1239,2445
6007,BUTTE,2017,6,1179,1315,2494
6007,BUTTE,2017,7,1266,1222,2488
6007,BUTTE,2017,8,1236,1254,2490
6007,BUTTE,2017,9,1241,1257,2498
6007,BUTTE,2017,10,1245,1324,2569
6007,BUTTE,2017,11,1288,1293,2581
6007,BUTTE,2017,12,1252,1278,2530
6007,BUTTE,2017,13,1316,1280,2596
6007,BUTTE,2017,14,1285,1313,2598
6007,BUTTE,2017,15,1263,1379,2642
6007,BUTTE,2017,16,1288,1426,2714
6007,BUTTE,2017,17,1371,1462,2833
6007,BUTTE,2017,18,2356,2435,4791
6007,BUTTE,2017,19,2348,2508,4856
6007,BUTTE,2017,20,2928,3181,6109
6007,BUTTE,2017,21,2753,3169,5922
6007,BUTTE,2017,22,2527,2851,5378
6007,BUTTE,2017,23,2246,2510,4756
6007,BUTTE,2017,24,1923,2099,4022
6007,BUTTE,2017,25,1908,2096,4004
6007,BUTTE,2017,26,1667,1889,3556
6007,BUTTE,2017,27,1331,1454,2785
6007,BUTTE,2017,28,1324,1464,2788
6007,BUTTE,2017,29,1286,1368,2654
6007,BUTTE,2017,30,1132,1258,2390
6007,BUTTE,2017,31,1084,1336,2420
6007,BUTTE,2017,32,1143,1269,2412
6007,BUTTE,2017,33,1238,1466,2704
6007,BUTTE,2017,34,1280,1430,2710
6007,BUTTE,2017,35,1241,1362,2603
6007,BUTTE,2017,36,1199,1352,2551
6007,BUTTE,2017,37,1227,1435,2662
6007,BUTTE,2017,38,1146,1296,2442
6007,BUTTE,2017,39,1092,1203,2295
6007,BUTTE,2017,40,1137,1171,2308
6007,BUTTE,2017,41,1081,1223,2304
6007,BUTTE,2017,42,1113,1133,2246
6007,BUTTE,2017,43,1108,1171,2279
6007,BUTTE,2017,44,1151,1250,2401
6007,BUTTE,2017,45,1182,1208,2390
6007,BUTTE,2017,46,1239,1271,2510
6007,BUTTE,2017,47,1275,1260,2535
6007,BUTTE,2017,48,1186,1180,2366
6007,BUTTE,2017,49,1108,1126,2234
6007,BUTTE,2017,50,1093,1073,2166
6007,BUTTE,2017,51,1035,1099,2134
6007,BUTTE,2017,52,1153,1067,2220
6007,BUTTE,2017,53,1163,1095,2258
6007,BUTTE,2017,54,1196,1133,2329
6007,BUTTE,2017,55,1223,1157,2380
6007,BUTTE,2017,56,1338,1201,2539
6007,BUTTE,2017,57,1328,1270,2598
6007,BUTTE,2017,58,1364,1310,2674
6007,BUTTE,2017,59,1381,1311,2692
6007,BUTTE,2017,60,1466,1374,2840
6007,BUTTE,2017,61,1512,1336,2848
6007,BUTTE,2017,62,1580,1402,2982
6007,BUTTE,2017,63,1659,1424,3083
6007,BUTTE,2017,64,1579,1366,2945
6007,BUTTE,2017,65,1499,1355,2854
6007,BUTTE,2017,66,1513,1271,2784
6007,BUTTE,2017,67,1435,1284,2719
6007,BUTTE,2017,68,1375,1255,2630
6007,BUTTE,2017,69,1386,1251,2637
6007,BUTTE,2017,70,1370,1216,2586
6007,BUTTE,2017,71,1125,1001,2126
6007,BUTTE,2017,72,1086,904,1990
6007,BUTTE,2017,73,1041,746,1787
6007,BUTTE,2017,74,964,895,1859
6007,BUTTE,2017,75,923,678,1601
6007,BUTTE,2017,76,801,689,1490
6007,BUTTE,2017,77,787,606,1393
6007,BUTTE,2017,78,728,596,1324
6007,BUTTE,2017,79,634,533,1167
6007,BUTTE,2017,80,676,509,1185
6007,BUTTE,2017,81,585,445,1030
6007,BUTTE,2017,82,570,416,986
6007,BUTTE,2017,83,519,335,854
6007,BUTTE,2017,84,478,356,834
6007,BUTTE,2017,85,448,335,783
6007,BUTTE,2017,86,478,323,801
6007,BUTTE,2017,87,480,261,741
6007,BUTTE,2017,88,397,214,611
6007,BUTTE,2017,89,398,216,614
6007,BUTTE,2017,90,321,178,499
6007,BUTTE,2017,91,321,135,456
6007,BUTTE,2017,92,235,101,336
6007,BUTTE,2017,93,200,87,287
6007,BUTTE,2017,94,175,58,233
6007,BUTTE,2017,95,118,53,171
6007,BUTTE,2017,96,102,32,134
6007,BUTTE,2017,97,66,16,82
6007,BUTTE,2017,98,54,21,75
6007,BUTTE,2017,99,19,6,25
6007,BUTTE,2017,100,29,5,34
6007,BUTTE,2018,0,1158,1257,2415
6007,BUTTE,2018,1,1146,1281,2427
6007,BUTTE,2018,2,1208,1231,2439
6007,BUTTE,2018,3,1220,1262,2482
6007,BUTTE,2018,4,1223,1318,2541
6007,BUTTE,2018,5,1205,1165,2370
6007,BUTTE,2018,6,1214,1242,2456
6007,BUTTE,2018,7,1177,1316,2493
6007,BUTTE,2018,8,1268,1230,2498
6007,BUTTE,2018,9,1245,1254,2499
6007,BUTTE,2018,10,1242,1262,2504
6007,BUTTE,2018,11,1248,1360,2608
6007,BUTTE,2018,12,1304,1309,2613
6007,BUTTE,2018,13,1293,1280,2573
6007,BUTTE,2018,14,1322,1290,2612
6007,BUTTE,2018,15,1286,1346,2632
6007,BUTTE,2018,16,1296,1421,2717
6007,BUTTE,2018,17,1349,1474,2823
6007,BUTTE,2018,18,2430,2417,4847
6007,BUTTE,2018,19,2266,2652,4918
6007,BUTTE,2018,20,2937,3139,6076
6007,BUTTE,2018,21,2790,3079,5869
6007,BUTTE,2018,22,2585,2946,5531
6007,BUTTE,2018,23,2335,2658,4993
6007,BUTTE,2018,24,1923,2158,4081
6007,BUTTE,2018,25,1746,1894,3640
6007,BUTTE,2018,26,1562,1753,3315
6007,BUTTE,2018,27,1719,1899,3618
6007,BUTTE,2018,28,1291,1457,2748
6007,BUTTE,2018,29,1287,1377,2664
6007,BUTTE,2018,30,1276,1364,2640
6007,BUTTE,2018,31,1125,1264,2389
6007,BUTTE,2018,32,1100,1346,2446
6007,BUTTE,2018,33,1123,1285,2408
6007,BUTTE,2018,34,1245,1451,2696
6007,BUTTE,2018,35,1282,1430,2712
6007,BUTTE,2018,36,1242,1365,2607
6007,BUTTE,2018,37,1191,1347,2538
6007,BUTTE,2018,38,1224,1433,2657
6007,BUTTE,2018,39,1156,1284,2440
6007,BUTTE,2018,40,1087,1213,2300
6007,BUTTE,2018,41,1163,1205,2368
6007,BUTTE,2018,42,1097,1226,2323
6007,BUTTE,2018,43,1150,1157,2307
6007,BUTTE,2018,44,1115,1192,2307
6007,BUTTE,2018,45,1164,1249,2413
6007,BUTTE,2018,46,1163,1184,2347
6007,BUTTE,2018,47,1226,1266,2492
6007,BUTTE,2018,48,1255,1238,2493
6007,BUTTE,2018,49,1169,1151,2320
6007,BUTTE,2018,50,1088,1122,2210
6007,BUTTE,2018,51,1068,1041,2109
6007,BUTTE,2018,52,1026,1091,2117
6007,BUTTE,2018,53,1117,1032,2149
6007,BUTTE,2018,54,1134,1078,2212
6007,BUTTE,2018,55,1180,1099,2279
6007,BUTTE,2018,56,1232,1158,2390
6007,BUTTE,2018,57,1347,1199,2546
6007,BUTTE,2018,58,1332,1245,2577
6007,BUTTE,2018,59,1376,1290,2666
6007,BUTTE,2018,60,1389,1324,2713
6007,BUTTE,2018,61,1468,1349,2817
6007,BUTTE,2018,62,1504,1312,2816
6007,BUTTE,2018,63,1577,1381,2958
6007,BUTTE,2018,64,1644,1402,3046
6007,BUTTE,2018,65,1569,1360,2929
6007,BUTTE,2018,66,1481,1329,2810
6007,BUTTE,2018,67,1516,1250,2766
6007,BUTTE,2018,68,1420,1266,2686
6007,BUTTE,2018,69,1358,1237,2595
6007,BUTTE,2018,70,1374,1244,2618
6007,BUTTE,2018,71,1338,1188,2526
6007,BUTTE,2018,72,1104,976,2080
6007,BUTTE,2018,73,1060,880,1940
6007,BUTTE,2018,74,1014,733,1747
6007,BUTTE,2018,75,963,870,1833
6007,BUTTE,2018,76,894,655,1549
6007,BUTTE,2018,77,781,678,1459
6007,BUTTE,2018,78,781,572,1353
6007,BUTTE,2018,79,697,568,1265
6007,BUTTE,2018,80,645,515,1160
6007,BUTTE,2018,81,629,473,1102
6007,BUTTE,2018,82,563,404,967
6007,BUTTE,2018,83,527,385,912
6007,BUTTE,2018,84,481,317,798
6007,BUTTE,2018,85,510,331,841
6007,BUTTE,2018,86,417,316,733
6007,BUTTE,2018,87,454,285,739
6007,BUTTE,2018,88,414,228,642
6007,BUTTE,2018,89,368,183,551
6007,BUTTE,2018,90,353,201,554
6007,BUTTE,2018,91,278,124,402
6007,BUTTE,2018,92,250,113,363
6007,BUTTE,2018,93,190,79,269
6007,BUTTE,2018,94,172,60,232
6007,BUTTE,2018,95,157,48,205
6007,BUTTE,2018,96,86,37,123
6007,BUTTE,2018,97,81,19,100
6007,BUTTE,2018,98,48,14,62
6007,BUTTE,2018,99,45,17,62
6007,BUTTE,2018,100,27,2,29
6007,BUTTE,2019,0,1153,1304,2457
6007,BUTTE,2019,1,1145,1246,2391
6007,BUTTE,2019,2,1156,1285,2441
6007,BUTTE,2019,3,1225,1240,2465
6007,BUTTE,2019,4,1225,1273,2498
6007,BUTTE,2019,5,1231,1320,2551
6007,BUTTE,2019,6,1211,1170,2381
6007,BUTTE,2019,7,1214,1243,2457
6007,BUTTE,2019,8,1179,1324,2503
6007,BUTTE,2019,9,1275,1231,2506
6007,BUTTE,2019,10,1246,1258,2504
6007,BUTTE,2019,11,1244,1305,2549
6007,BUTTE,2019,12,1274,1383,2657
6007,BUTTE,2019,13,1329,1311,2640
6007,BUTTE,2019,14,1303,1285,2588
6007,BUTTE,2019,15,1323,1326,2649
6007,BUTTE,2019,16,1319,1393,2712
6007,BUTTE,2019,17,1362,1470,2832
6007,BUTTE,2019,18,2402,2434,4836
6007,BUTTE,2019,19,2329,2643,4972
6007,BUTTE,2019,20,2856,3288,6144
6007,BUTTE,2019,21,2796,3031,5827
6007,BUTTE,2019,22,2616,2859,5475
6007,BUTTE,2019,23,2398,2763,5161
6007,BUTTE,2019,24,2010,2312,4322
6007,BUTTE,2019,25,1753,1943,3696
6007,BUTTE,2019,26,1402,1556,2958
6007,BUTTE,2019,27,1622,1765,3387
6007,BUTTE,2019,28,1678,1895,3573
6007,BUTTE,2019,29,1250,1372,2622
6007,BUTTE,2019,30,1278,1384,2662
6007,BUTTE,2019,31,1266,1377,2643
6007,BUTTE,2019,32,1144,1269,2413
6007,BUTTE,2019,33,1080,1367,2447
6007,BUTTE,2019,34,1132,1270,2402
6007,BUTTE,2019,35,1244,1451,2695
6007,BUTTE,2019,36,1285,1433,2718
6007,BUTTE,2019,37,1234,1368,2602
6007,BUTTE,2019,38,1188,1347,2535
6007,BUTTE,2019,39,1234,1420,2654
6007,BUTTE,2019,40,1150,1290,2440
6007,BUTTE,2019,41,1109,1253,2362
6007,BUTTE,2019,42,1178,1211,2389
6007,BUTTE,2019,43,1131,1252,2383
6007,BUTTE,2019,44,1164,1183,2347
6007,BUTTE,2019,45,1120,1178,2298
6007,BUTTE,2019,46,1146,1230,2376
6007,BUTTE,2019,47,1151,1179,2330
6007,BUTTE,2019,48,1209,1255,2464
6007,BUTTE,2019,49,1242,1195,2437
6007,BUTTE,2019,50,1150,1144,2294
6007,BUTTE,2019,51,1072,1091,2163
6007,BUTTE,2019,52,1046,1025,2071
6007,BUTTE,2019,53,997,1070,2067
6007,BUTTE,2019,54,1088,1015,2103
6007,BUTTE,2019,55,1118,1036,2154
6007,BUTTE,2019,56,1190,1101,2291
6007,BUTTE,2019,57,1259,1157,2416
6007,BUTTE,2019,58,1345,1180,2525
6007,BUTTE,2019,59,1339,1232,2571
6007,BUTTE,2019,60,1368,1300,2668
6007,BUTTE,2019,61,1385,1299,2684
6007,BUTTE,2019,62,1468,1336,2804
6007,BUTTE,2019,63,1507,1293,2800
6007,BUTTE,2019,64,1562,1360,2922
6007,BUTTE,2019,65,1639,1391,3030
6007,BUTTE,2019,66,1550,1331,2881
6007,BUTTE,2019,67,1477,1294,2771
6007,BUTTE,2019,68,1501,1235,2736
6007,BUTTE,2019,69,1410,1248,2658
6007,BUTTE,2019,70,1350,1221,2571
6007,BUTTE,2019,71,1364,1212,2576
6007,BUTTE,2019,72,1313,1160,2473
6007,BUTTE,2019,73,1078,947,2025
6007,BUTTE,2019,74,1039,852,1891
6007,BUTTE,2019,75,1018,717,1735
6007,BUTTE,2019,76,911,846,1757
6007,BUTTE,2019,77,875,639,1514
6007,BUTTE,2019,78,775,641,1416
6007,BUTTE,2019,79,750,558,1308
6007,BUTTE,2019,80,705,546,1251
6007,BUTTE,2019,81,602,480,1082
6007,BUTTE,2019,82,596,436,1032
6007,BUTTE,2019,83,526,383,909
6007,BUTTE,2019,84,494,368,862
6007,BUTTE,2019,85,515,297,812
6007,BUTTE,2019,86,488,312,800
6007,BUTTE,2019,87,398,286,684
6007,BUTTE,2019,88,394,256,650
6007,BUTTE,2019,89,386,207,593
6007,BUTTE,2019,90,332,172,504
6007,BUTTE,2019,91,312,157,469
6007,BUTTE,2019,92,218,96,314
6007,BUTTE,2019,93,204,94,298
6007,BUTTE,2019,94,147,60,207
6007,BUTTE,2019,95,142,50,192
6007,BUTTE,2019,96,112,34,146
6007,BUTTE,2019,97,63,23,86
6007,BUTTE,2019,98,63,13,76
6007,BUTTE,2019,99,39,6,45
6007,BUTTE,2019,100,49,16,65
6009,CALAVERAS,2017,0,178,198,376
6009,CALAVERAS,2017,1,164,195,359
6009,CALAVERAS,2017,2,174,179,353
6009,CALAVERAS,2017,3,170,186,356
6009,CALAVERAS,2017,4,168,155,323
6009,CALAVERAS,2017,5,168,184,352
6009,CALAVERAS,2017,6,161,176,337
6009,CALAVERAS,2017,7,173,194,367
6009,CALAVERAS,2017,8,192,186,378
6009,CALAVERAS,2017,9,195,222,417
6009,CALAVERAS,2017,10,234,208,442
6009,CALAVERAS,2017,11,203,209,412
6009,CALAVERAS,2017,12,207,210,417
6009,CALAVERAS,2017,13,190,230,420
6009,CALAVERAS,2017,14,207,228,435
6009,CALAVERAS,2017,15,218,238,456
6009,CALAVERAS,2017,16,255,260,515
6009,CALAVERAS,2017,17,253,283,536
6009,CALAVERAS,2017,18,227,317,544
6009,CALAVERAS,2017,19,268,322,590
6009,CALAVERAS,2017,20,276,283,559
6009,CALAVERAS,2017,21,288,282,570
6009,CALAVERAS,2017,22,307,320,627
6009,CALAVERAS,2017,23,316,333,649
6009,CALAVERAS,2017,24,252,340,592
6009,CALAVERAS,2017,25,242,287,529
6009,CALAVERAS,2017,26,209,240,449
6009,CALAVERAS,2017,27,179,201,380
6009,CALAVERAS,2017,28,179,204,383
6009,CALAVERAS,2017,29,164,181,345
6009,CALAVERAS,2017,30,170,199,369
6009,CALAVERAS,2017,31,190,198,388
6009,CALAVERAS,2017,32,170,192,362
6009,CALAVERAS,2017,33,175,190,365
6009,CALAVERAS,2017,34,164,209,373
6009,CALAVERAS,2017,35,165,182,347
6009,CALAVERAS,2017,36,162,201,363
6009,CALAVERAS,2017,37,192,146,338
6009,CALAVERAS,2017,38,180,181,361
6009,CALAVERAS,2017,39,165,181,346
6009,CALAVERAS,2017,40,183,188,371
6009,CALAVERAS,2017,41,176,157,333
6009,CALAVERAS,2017,42,163,191,354
6009,CALAVERAS,2017,43,182,181,363
6009,CALAVERAS,2017,44,187,171,358
6009,CALAVERAS,2017,45,212,196,408
6009,CALAVERAS,2017,46,218,230,448
6009,CALAVERAS,2017,47,271,246,517
6009,CALAVERAS,2017,48,276,222,498
6009,CALAVERAS,2017,49,241,244,485
6009,CALAVERAS,2017,50,281,257,538
6009,CALAVERAS,2017,51,256,271,527
6009,CALAVERAS,2017,52,297,277,574
6009,CALAVERAS,2017,53,307,330,637
6009,CALAVERAS,2017,54,328,339,667
6009,CALAVERAS,2017,55,319,308,627
6009,CALAVERAS,2017,56,374,372,746
6009,CALAVERAS,2017,57,424,355,779
6009,CALAVERAS,2017,58,419,375,794
6009,CALAVERAS,2017,59,418,398,816
6009,CALAVERAS,2017,60,400,406,806
6009,CALAVERAS,2017,61,430,410,840
6009,CALAVERAS,2017,62,436,359,795
6009,CALAVERAS,2017,63,501,379,880
6009,CALAVERAS,2017,64,452,394,846
6009,CALAVERAS,2017,65,430,352,782
6009,CALAVERAS,2017,66,364,404,768
6009,CALAVERAS,2017,67,417,402,819
6009,CALAVERAS,2017,68,400,396,796
6009,CALAVERAS,2017,69,420,370,790
6009,CALAVERAS,2017,70,442,408,850
6009,CALAVERAS,2017,71,355,329,684
6009,CALAVERAS,2017,72,308,346,654
6009,CALAVERAS,2017,73,309,299,608
6009,CALAVERAS,2017,74,339,322,661
6009,CALAVERAS,2017,75,274,264,538
6009,CALAVERAS,2017,76,287,234,521
6009,CALAVERAS,2017,77,219,249,468
6009,CALAVERAS,2017,78,212,209,421
6009,CALAVERAS,2017,79,231,223,454
6009,CALAVERAS,2017,80,219,188,407
6009,CALAVERAS,2017,81,168,165,333
6009,CALAVERAS,2017,82,191,169,360
6009,CALAVERAS,2017,83,131,136,267
6009,CALAVERAS,2017,84,131,126,257
6009,CALAVERAS,2017,85,110,98,208
6009,CALAVERAS,2017,86,100,88,188
6009,CALAVERAS,2017,87,110,63,173
6009,CALAVERAS,2017,88,76,58,134
6009,CALAVERAS,2017,89,58,55,113
6009,CALAVERAS,2017,90,56,64,120
6009,CALAVERAS,2017,91,43,38,81
6009,CALAVERAS,2017,92,60,27,87
6009,CALAVERAS,2017,93,31,32,63
6009,CALAVERAS,2017,94,24,12,36
6009,CALAVERAS,2017,95,19,9,28
6009,CALAVERAS,2017,96,22,5,27
6009,CALAVERAS,2017,97,11,5,16
6009,CALAVERAS,2017,98,4,0,4
6009,CALAVERAS,2017,99,6,2,8
6009,CALAVERAS,2017,100,6,1,7
6009,CALAVERAS,2018,0,182,200,382
6009,CALAVERAS,2018,1,178,196,374
6009,CALAVERAS,2018,2,166,195,361
6009,CALAVERAS,2018,3,172,178,350
6009,CALAVERAS,2018,4,170,187,357
6009,CALAVERAS,2018,5,169,154,323
6009,CALAVERAS,2018,6,170,190,360
6009,CALAVERAS,2018,7,163,175,338
6009,CALAVERAS,2018,8,175,201,376
6009,CALAVERAS,2018,9,190,185,375
6009,CALAVERAS,2018,10,201,231,432
6009,CALAVERAS,2018,11,234,210,444
6009,CALAVERAS,2018,12,204,208,412
6009,CALAVERAS,2018,13,206,211,417
6009,CALAVERAS,2018,14,190,230,420
6009,CALAVERAS,2018,15,209,238,447
6009,CALAVERAS,2018,16,221,240,461
6009,CALAVERAS,2018,17,249,273,522
6009,CALAVERAS,2018,18,254,290,544
6009,CALAVERAS,2018,19,226,310,536
6009,CALAVERAS,2018,20,267,295,562
6009,CALAVERAS,2018,21,277,283,560
6009,CALAVERAS,2018,22,289,293,582
6009,CALAVERAS,2018,23,307,314,621
6009,CALAVERAS,2018,24,313,332,645
6009,CALAVERAS,2018,25,252,339,591
6009,CALAVERAS,2018,26,241,287,528
6009,CALAVERAS,2018,27,210,235,445
6009,CALAVERAS,2018,28,178,208,386
6009,CALAVERAS,2018,29,179,204,383
6009,CALAVERAS,2018,30,165,176,341
6009,CALAVERAS,2018,31,170,200,370
6009,CALAVERAS,2018,32,190,196,386
6009,CALAVERAS,2018,33,169,195,364
6009,CALAVERAS,2018,34,174,187,361
6009,CALAVERAS,2018,35,166,209,375
6009,CALAVERAS,2018,36,164,183,347
6009,CALAVERAS,2018,37,164,199,363
6009,CALAVERAS,2018,38,191,143,334
6009,CALAVERAS,2018,39,179,188,367
6009,CALAVERAS,2018,40,165,177,342
6009,CALAVERAS,2018,41,183,187,370
6009,CALAVERAS,2018,42,175,155,330
6009,CALAVERAS,2018,43,165,192,357
6009,CALAVERAS,2018,44,179,181,360
6009,CALAVERAS,2018,45,189,170,359
6009,CALAVERAS,2018,46,212,204,416
6009,CALAVERAS,2018,47,223,235,458
6009,CALAVERAS,2018,48,271,250,521
6009,CALAVERAS,2018,49,275,220,495
6009,CALAVERAS,2018,50,242,247,489
6009,CALAVERAS,2018,51,276,256,532
6009,CALAVERAS,2018,52,255,270,525
6009,CALAVERAS,2018,53,298,278,576
6009,CALAVERAS,2018,54,305,322,627
6009,CALAVERAS,2018,55,328,336,664
6009,CALAVERAS,2018,56,316,312,628
6009,CALAVERAS,2018,57,378,379,757
6009,CALAVERAS,2018,58,430,364,794
6009,CALAVERAS,2018,59,420,379,799
6009,CALAVERAS,2018,60,418,400,818
6009,CALAVERAS,2018,61,409,410,819
6009,CALAVERAS,2018,62,435,413,848
6009,CALAVERAS,2018,63,441,365,806
6009,CALAVERAS,2018,64,512,375,887
6009,CALAVERAS,2018,65,454,391,845
6009,CALAVERAS,2018,66,427,347,774
6009,CALAVERAS,2018,67,371,401,772
6009,CALAVERAS,2018,68,412,405,817
6009,CALAVERAS,2018,69,394,393,787
6009,CALAVERAS,2018,70,418,364,782
6009,CALAVERAS,2018,71,436,398,834
6009,CALAVERAS,2018,72,351,320,671
6009,CALAVERAS,2018,73,304,337,641
6009,CALAVERAS,2018,74,304,296,600
6009,CALAVERAS,2018,75,332,317,649
6009,CALAVERAS,2018,76,270,254,524
6009,CALAVERAS,2018,77,281,223,504
6009,CALAVERAS,2018,78,213,242,455
6009,CALAVERAS,2018,79,209,205,414
6009,CALAVERAS,2018,80,220,219,439
6009,CALAVERAS,2018,81,213,182,395
6009,CALAVERAS,2018,82,153,162,315
6009,CALAVERAS,2018,83,187,157,344
6009,CALAVERAS,2018,84,121,130,251
6009,CALAVERAS,2018,85,126,118,244
6009,CALAVERAS,2018,86,100,85,185
6009,CALAVERAS,2018,87,93,86,179
6009,CALAVERAS,2018,88,97,57,154
6009,CALAVERAS,2018,89,66,48,114
6009,CALAVERAS,2018,90,53,55,108
6009,CALAVERAS,2018,91,56,50,106
6009,CALAVERAS,2018,92,33,28,61
6009,CALAVERAS,2018,93,52,26,78
6009,CALAVERAS,2018,94,23,26,49
6009,CALAVERAS,2018,95,23,9,32
6009,CALAVERAS,2018,96,11,5,16
6009,CALAVERAS,2018,97,19,6,25
6009,CALAVERAS,2018,98,4,2,6
6009,CALAVERAS,2018,99,4,0,4
6009,CALAVERAS,2018,100,6,2,8
6009,CALAVERAS,2019,0,200,190,390
6009,CALAVERAS,2019,1,181,200,381
6009,CALAVERAS,2019,2,180,196,376
6009,CALAVERAS,2019,3,164,193,357
6009,CALAVERAS,2019,4,172,179,351
6009,CALAVERAS,2019,5,171,187,358
6009,CALAVERAS,2019,6,168,162,330
6009,CALAVERAS,2019,7,172,191,363
6009,CALAVERAS,2019,8,168,183,351
6009,CALAVERAS,2019,9,173,202,375
6009,CALAVERAS,2019,10,193,193,386
6009,CALAVERAS,2019,11,201,233,434
6009,CALAVERAS,2019,12,235,209,444
6009,CALAVERAS,2019,13,203,209,412
6009,CALAVERAS,2019,14,206,211,417
6009,CALAVERAS,2019,15,191,244,435
6009,CALAVERAS,2019,16,212,239,451
6009,CALAVERAS,2019,17,218,250,468
6009,CALAVERAS,2019,18,251,280,531
6009,CALAVERAS,2019,19,253,284,537
6009,CALAVERAS,2019,20,225,283,508
6009,CALAVERAS,2019,21,268,295,563
6009,CALAVERAS,2019,22,278,294,572
6009,CALAVERAS,2019,23,289,286,575
6009,CALAVERAS,2019,24,305,312,617
6009,CALAVERAS,2019,25,313,333,646
6009,CALAVERAS,2019,26,252,339,591
6009,CALAVERAS,2019,27,242,282,524
6009,CALAVERAS,2019,28,209,242,451
6009,CALAVERAS,2019,29,178,208,386
6009,CALAVERAS,2019,30,180,198,378
6009,CALAVERAS,2019,31,165,177,342
6009,CALAVERAS,2019,32,169,199,368
6009,CALAVERAS,2019,33,190,199,389
6009,CALAVERAS,2019,34,168,192,360
6009,CALAVERAS,2019,35,176,187,363
6009,CALAVERAS,2019,36,165,210,375
6009,CALAVERAS,2019,37,166,182,348
6009,CALAVERAS,2019,38,163,196,359
6009,CALAVERAS,2019,39,190,150,340
6009,CALAVERAS,2019,40,179,184,363
6009,CALAVERAS,2019,41,165,177,342
6009,CALAVERAS,2019,42,182,185,367
6009,CALAVERAS,2019,43,178,156,334
6009,CALAVERAS,2019,44,161,192,353
6009,CALAVERAS,2019,45,183,180,363
6009,CALAVERAS,2019,46,187,175,362
6009,CALAVERAS,2019,47,217,202,419
6009,CALAVERAS,2019,48,223,238,461
6009,CALAVERAS,2019,49,274,252,526
6009,CALAVERAS,2019,50,279,223,502
6009,CALAVERAS,2019,51,239,243,482
6009,CALAVERAS,2019,52,275,255,530
6009,CALAVERAS,2019,53,258,274,532
6009,CALAVERAS,2019,54,298,269,567
6009,CALAVERAS,2019,55,306,319,625
6009,CALAVERAS,2019,56,325,342,667
6009,CALAVERAS,2019,57,319,316,635
6009,CALAVERAS,2019,58,382,387,769
6009,CALAVERAS,2019,59,435,371,806
6009,CALAVERAS,2019,60,424,374,798
6009,CALAVERAS,2019,61,428,409,837
6009,CALAVERAS,2019,62,411,414,825
6009,CALAVERAS,2019,63,448,413,861
6009,CALAVERAS,2019,64,447,359,806
6009,CALAVERAS,2019,65,510,378,888
6009,CALAVERAS,2019,66,453,386,839
6009,CALAVERAS,2019,67,430,339,769
6009,CALAVERAS,2019,68,371,405,776
6009,CALAVERAS,2019,69,410,401,811
6009,CALAVERAS,2019,70,395,390,785
6009,CALAVERAS,2019,71,412,353,765
6009,CALAVERAS,2019,72,432,395,827
6009,CALAVERAS,2019,73,346,314,660
6009,CALAVERAS,2019,74,300,330,630
6009,CALAVERAS,2019,75,297,291,588
6009,CALAVERAS,2019,76,328,305,633
6009,CALAVERAS,2019,77,260,246,506
6009,CALAVERAS,2019,78,273,219,492
6009,CALAVERAS,2019,79,207,239,446
6009,CALAVERAS,2019,80,208,200,408
6009,CALAVERAS,2019,81,210,206,416
6009,CALAVERAS,2019,82,202,175,377
6009,CALAVERAS,2019,83,148,149,297
6009,CALAVERAS,2019,84,176,151,327
6009,CALAVERAS,2019,85,121,125,246
6009,CALAVERAS,2019,86,120,104,224
6009,CALAVERAS,2019,87,93,76,169
6009,CALAVERAS,2019,88,85,72,157
6009,CALAVERAS,2019,89,78,49,127
6009,CALAVERAS,2019,90,64,48,112
6009,CALAVERAS,2019,91,50,43,93
6009,CALAVERAS,2019,92,47,45,92
6009,CALAVERAS,2019,93,28,21,49
6009,CALAVERAS,2019,94,46,22,68
6009,CALAVERAS,2019,95,22,19,41
6009,CALAVERAS,2019,96,16,3,19
6009,CALAVERAS,2019,97,9,4,13
6009,CALAVERAS,2019,98,14,5,19
6009,CALAVERAS,2019,99,4,1,5
6009,CALAVERAS,2019,100,8,1,9
6011,COLUSA,2017,0,140,176,316
6011,COLUSA,2017,1,160,150,310
6011,COLUSA,2017,2,126,152,278
6011,COLUSA,2017,3,162,162,324
6011,COLUSA,2017,4,160,161,321
6011,COLUSA,2017,5,161,136,297
6011,COLUSA,2017,6,174,162,336
6011,COLUSA,2017,7,135,175,310
6011,COLUSA,2017,8,146,196,342
6011,COLUSA,2017,9,181,211,392
6011,COLUSA,2017,10,191,195,386
6011,COLUSA,2017,11,177,198,375
6011,COLUSA,2017,12,165,194,359
6011,COLUSA,2017,13,145,201,346
6011,COLUSA,2017,14,177,176,353
6011,COLUSA,2017,15,162,175,337
6011,COLUSA,2017,16,174,197,371
6011,COLUSA,2017,17,163,204,367
6011,COLUSA,2017,18,165,182,347
6011,COLUSA,2017,19,164,189,353
6011,COLUSA,2017,20,146,172,318
6011,COLUSA,2017,21,152,190,342
6011,COLUSA,2017,22,172,182,354
6011,COLUSA,2017,23,183,187,370
6011,COLUSA,2017,24,169,189,358
6011,COLUSA,2017,25,157,199,356
6011,COLUSA,2017,26,144,154,298
6011,COLUSA,2017,27,132,140,272
6011,COLUSA,2017,28,130,150,280
6011,COLUSA,2017,29,116,150,266
6011,COLUSA,2017,30,103,135,238
6011,COLUSA,2017,31,127,134,261
6011,COLUSA,2017,32,146,132,278
6011,COLUSA,2017,33,155,166,321
6011,COLUSA,2017,34,117,129,246
6011,COLUSA,2017,35,128,160,288
6011,COLUSA,2017,36,152,139,291
6011,COLUSA,2017,37,126,132,258
6011,COLUSA,2017,38,125,127,252
6011,COLUSA,2017,39,135,138,273
6011,COLUSA,2017,40,157,124,281
6011,COLUSA,2017,41,112,134,246
6011,COLUSA,2017,42,139,122,261
6011,COLUSA,2017,43,116,132,248
6011,COLUSA,2017,44,138,129,267
6011,COLUSA,2017,45,118,131,249
6011,COLUSA,2017,46,140,128,268
6011,COLUSA,2017,47,128,146,274
6011,COLUSA,2017,48,134,135,269
6011,COLUSA,2017,49,141,140,281
6011,COLUSA,2017,50,133,143,276
6011,COLUSA,2017,51,114,128,242
6011,COLUSA,2017,52,138,134,272
6011,COLUSA,2017,53,136,138,274
6011,COLUSA,2017,54,111,122,233
6011,COLUSA,2017,55,120,142,262
6011,COLUSA,2017,56,135,137,272
6011,COLUSA,2017,57,124,137,261
6011,COLUSA,2017,58,151,124,275
6011,COLUSA,2017,59,140,127,267
6011,COLUSA,2017,60,132,155,287
6011,COLUSA,2017,61,112,132,244
6011,COLUSA,2017,62,129,157,286
6011,COLUSA,2017,63,131,124,255
6011,COLUSA,2017,64,124,134,258
6011,COLUSA,2017,65,117,110,227
6011,COLUSA,2017,66,118,110,228
6011,COLUSA,2017,67,118,109,227
6011,COLUSA,2017,68,93,104,197
6011,COLUSA,2017,69,101,104,205
6011,COLUSA,2017,70,124,104,228
6011,COLUSA,2017,71,70,89,159
6011,COLUSA,2017,72,71,62,133
6011,COLUSA,2017,73,75,86,161
6011,COLUSA,2017,74,82,75,157
6011,COLUSA,2017,75,74,72,146
6011,COLUSA,2017,76,67,64,131
6011,COLUSA,2017,77,52,60,112
6011,COLUSA,2017,78,48,44,92
6011,COLUSA,2017,79,43,52,95
6011,COLUSA,2017,80,47,35,82
6011,COLUSA,2017,81,38,36,74
6011,COLUSA,2017,82,42,36,78
6011,COLUSA,2017,83,34,15,49
6011,COLUSA,2017,84,36,23,59
6011,COLUSA,2017,85,38,15,53
6011,COLUSA,2017,86,33,30,63
6011,COLUSA,2017,87,37,24,61
6011,COLUSA,2017,88,24,13,37
6011,COLUSA,2017,89,24,16,40
6011,COLUSA,2017,90,32,10,42
6011,COLUSA,2017,91,16,7,23
6011,COLUSA,2017,92,22,4,26
6011,COLUSA,2017,93,12,8,20
6011,COLUSA,2017,94,13,5,18
6011,COLUSA,2017,95,7,6,13
6011,COLUSA,2017,96,7,7,14
6011,COLUSA,2017,97,2,0,2
6011,COLUSA,2017,98,4,0,4
6011,COLUSA,2017,99,5,0,5
6011,COLUSA,2017,100,2,1,3
6011,COLUSA,2018,0,129,174,303
6011,COLUSA,2018,1,141,176,317
6011,COLUSA,2018,2,164,152,316
6011,COLUSA,2018,3,133,154,287
6011,COLUSA,2018,4,162,166,328
6011,COLUSA,2018,5,161,162,323
6011,COLUSA,2018,6,160,136,296
6011,COLUSA,2018,7,174,158,332
6011,COLUSA,2018,8,135,174,309
6011,COLUSA,2018,9,145,195,340
6011,COLUSA,2018,10,180,212,392
6011,COLUSA,2018,11,192,195,387
6011,COLUSA,2018,12,178,200,378
6011,COLUSA,2018,13,167,201,368
6011,COLUSA,2018,14,145,203,348
6011,COLUSA,2018,15,178,184,362
6011,COLUSA,2018,16,162,182,344
6011,COLUSA,2018,17,171,209,380
6011,COLUSA,2018,18,163,184,347
6011,COLUSA,2018,19,164,195,359
6011,COLUSA,2018,20,163,157,320
6011,COLUSA,2018,21,146,173,319
6011,COLUSA,2018,22,154,191,345
6011,COLUSA,2018,23,169,183,352
6011,COLUSA,2018,24,186,182,368
6011,COLUSA,2018,25,166,190,356
6011,COLUSA,2018,26,161,204,365
6011,COLUSA,2018,27,150,156,306
6011,COLUSA,2018,28,133,144,277
6011,COLUSA,2018,29,131,150,281
6011,COLUSA,2018,30,119,155,274
6011,COLUSA,2018,31,103,134,237
6011,COLUSA,2018,32,127,133,260
6011,COLUSA,2018,33,145,135,280
6011,COLUSA,2018,34,155,164,319
6011,COLUSA,2018,35,118,128,246
6011,COLUSA,2018,36,127,156,283
6011,COLUSA,2018,37,152,138,290
6011,COLUSA,2018,38,126,134,260
6011,COLUSA,2018,39,125,124,249
6011,COLUSA,2018,40,137,136,273
6011,COLUSA,2018,41,155,124,279
6011,COLUSA,2018,42,111,133,244
6011,COLUSA,2018,43,139,121,260
6011,COLUSA,2018,44,113,130,243
6011,COLUSA,2018,45,138,127,265
6011,COLUSA,2018,46,118,131,249
6011,COLUSA,2018,47,140,128,268
6011,COLUSA,2018,48,127,148,275
6011,COLUSA,2018,49,136,132,268
6011,COLUSA,2018,50,140,139,279
6011,COLUSA,2018,51,132,143,275
6011,COLUSA,2018,52,115,126,241
6011,COLUSA,2018,53,137,134,271
6011,COLUSA,2018,54,135,137,272
6011,COLUSA,2018,55,111,120,231
6011,COLUSA,2018,56,120,141,261
6011,COLUSA,2018,57,136,137,273
6011,COLUSA,2018,58,124,137,261
6011,COLUSA,2018,59,152,124,276
6011,COLUSA,2018,60,136,127,263
6011,COLUSA,2018,61,130,151,281
6011,COLUSA,2018,62,111,133,244
6011,COLUSA,2018,63,127,156,283
6011,COLUSA,2018,64,131,122,253
6011,COLUSA,2018,65,123,134,257
6011,COLUSA,2018,66,117,111,228
6011,COLUSA,2018,67,120,105,225
6011,COLUSA,2018,68,116,106,222
6011,COLUSA,2018,69,94,104,198
6011,COLUSA,2018,70,99,103,202
6011,COLUSA,2018,71,118,103,221
6011,COLUSA,2018,72,66,86,152
6011,COLUSA,2018,73,68,61,129
6011,COLUSA,2018,74,71,85,156
6011,COLUSA,2018,75,81,75,156
6011,COLUSA,2018,76,73,67,140
6011,COLUSA,2018,77,64,58,122
6011,COLUSA,2018,78,55,57,112
6011,COLUSA,2018,79,43,46,89
6011,COLUSA,2018,80,44,47,91
6011,COLUSA,2018,81,45,36,81
6011,COLUSA,2018,82,37,31,68
6011,COLUSA,2018,83,38,34,72
6011,COLUSA,2018,84,32,16,48
6011,COLUSA,2018,85,42,22,64
6011,COLUSA,2018,86,30,15,45
6011,COLUSA,2018,87,35,29,64
6011,COLUSA,2018,88,33,17,50
6011,COLUSA,2018,89,23,14,37
6011,COLUSA,2018,90,27,15,42
6011,COLUSA,2018,91,27,6,33
6011,COLUSA,2018,92,14,5,19
6011,COLUSA,2018,93,20,3,23
6011,COLUSA,2018,94,11,8,19
6011,COLUSA,2018,95,8,7,15
6011,COLUSA,2018,96,7,2,9
6011,COLUSA,2018,97,4,5,9
6011,COLUSA,2018,98,2,0,2
6011,COLUSA,2018,99,3,0,3
6011,COLUSA,2018,100,5,1,6
6011,COLUSA,2019,0,144,170,314
6011,COLUSA,2019,1,129,173,302
6011,COLUSA,2019,2,148,177,325
6011,COLUSA,2019,3,168,154,322
6011,COLUSA,2019,4,132,158,290
6011,COLUSA,2019,5,165,167,332
6011,COLUSA,2019,6,160,163,323
6011,COLUSA,2019,7,160,133,293
6011,COLUSA,2019,8,174,157,331
6011,COLUSA,2019,9,134,173,307
6011,COLUSA,2019,10,144,195,339
6011,COLUSA,2019,11,181,212,393
6011,COLUSA,2019,12,193,196,389
6011,COLUSA,2019,13,180,204,384
6011,COLUSA,2019,14,170,205,375
6011,COLUSA,2019,15,145,210,355
6011,COLUSA,2019,16,178,188,366
6011,COLUSA,2019,17,159,195,354
6011,COLUSA,2019,18,171,189,360
6011,COLUSA,2019,19,159,202,361
6011,COLUSA,2019,20,160,169,329
6011,COLUSA,2019,21,163,158,321
6011,COLUSA,2019,22,149,174,323
6011,COLUSA,2019,23,151,191,342
6011,COLUSA,2019,24,171,177,348
6011,COLUSA,2019,25,183,183,366
6011,COLUSA,2019,26,171,197,368
6011,COLUSA,2019,27,167,203,370
6011,COLUSA,2019,28,152,158,310
6011,COLUSA,2019,29,135,142,277
6011,COLUSA,2019,30,134,156,290
6011,COLUSA,2019,31,118,154,272
6011,COLUSA,2019,32,103,133,236
6011,COLUSA,2019,33,126,136,262
6011,COLUSA,2019,34,145,135,280
6011,COLUSA,2019,35,156,162,318
6011,COLUSA,2019,36,117,125,242
6011,COLUSA,2019,37,127,155,282
6011,COLUSA,2019,38,152,139,291
6011,COLUSA,2019,39,125,132,257
6011,COLUSA,2019,40,127,121,248
6011,COLUSA,2019,41,134,136,270
6011,COLUSA,2019,42,154,124,278
6011,COLUSA,2019,43,110,131,241
6011,COLUSA,2019,44,139,120,259
6011,COLUSA,2019,45,113,129,242
6011,COLUSA,2019,46,139,126,265
6011,COLUSA,2019,47,117,131,248
6011,COLUSA,2019,48,140,129,269
6011,COLUSA,2019,49,129,146,275
6011,COLUSA,2019,50,135,132,267
6011,COLUSA,2019,51,139,137,276
6011,COLUSA,2019,52,132,144,276
6011,COLUSA,2019,53,114,126,240
6011,COLUSA,2019,54,136,132,268
6011,COLUSA,2019,55,135,137,272
6011,COLUSA,2019,56,111,120,231
6011,COLUSA,2019,57,119,140,259
6011,COLUSA,2019,58,136,136,272
6011,COLUSA,2019,59,125,136,261
6011,COLUSA,2019,60,150,125,275
6011,COLUSA,2019,61,135,124,259
6011,COLUSA,2019,62,128,152,280
6011,COLUSA,2019,63,109,130,239
6011,COLUSA,2019,64,129,154,283
6011,COLUSA,2019,65,130,121,251
6011,COLUSA,2019,66,122,133,255
6011,COLUSA,2019,67,114,109,223
6011,COLUSA,2019,68,117,102,219
6011,COLUSA,2019,69,117,105,222
6011,COLUSA,2019,70,91,104,195
6011,COLUSA,2019,71,100,100,200
6011,COLUSA,2019,72,113,98,211
6011,COLUSA,2019,73,67,86,153
6011,COLUSA,2019,74,65,58,123
6011,COLUSA,2019,75,73,86,159
6011,COLUSA,2019,76,77,71,148
6011,COLUSA,2019,77,70,64,134
6011,COLUSA,2019,78,67,55,122
6011,COLUSA,2019,79,52,56,108
6011,COLUSA,2019,80,46,40,86
6011,COLUSA,2019,81,42,51,93
6011,COLUSA,2019,82,43,28,71
6011,COLUSA,2019,83,33,30,63
6011,COLUSA,2019,84,35,31,66
6011,COLUSA,2019,85,41,15,56
6011,COLUSA,2019,86,31,22,53
6011,COLUSA,2019,87,33,15,48
6011,COLUSA,2019,88,28,21,49
6011,COLUSA,2019,89,33,17,50
6011,COLUSA,2019,90,25,13,38
6011,COLUSA,2019,91,23,9,32
6011,COLUSA,2019,92,19,7,26
6011,COLUSA,2019,93,13,4,17
6011,COLUSA,2019,94,17,2,19
6011,COLUSA,2019,95,9,9,18
6011,COLUSA,2019,96,7,4,11
6011,COLUSA,2019,97,3,2,5
6011,COLUSA,2019,98,3,4,7
6011,COLUSA,2019,99,2,0,2
6011,COLUSA,2019,100,5,0,5
6013,CONTRA COSTA,2017,0,6053,6751,12804
6013,CONTRA COSTA,2017,1,6169,6339,12508
6013,CONTRA COSTA,2017,2,6197,6493,12690
6013,CONTRA COSTA,2017,3,6159,6406,12565
6013,CONTRA COSTA,2017,4,6397,6433,12830
6013,CONTRA COSTA,2017,5,6229,6399,12628
6013,CONTRA COSTA,2017,6,6502,6708,13210
6013,CONTRA COSTA,2017,7,6535,6858,13393
6013,CONTRA COSTA,2017,8,6857,7102,13959
6013,CONTRA COSTA,2017,9,7285,7334,14619
6013,CONTRA COSTA,2017,10,7440,7736,15176
6013,CONTRA COSTA,2017,11,7414,7552,14966
6013,CONTRA COSTA,2017,12,7209,7846,15055
6013,CONTRA COSTA,2017,13,7369,7776,15145
6013,CONTRA COSTA,2017,14,7384,7717,15101
6013,CONTRA COSTA,2017,15,7542,7713,15255
6013,CONTRA COSTA,2017,16,7293,7553,14846
6013,CONTRA COSTA,2017,17,6999,7391,14390
6013,CONTRA COSTA,2017,18,7115,7333,14448
6013,CONTRA COSTA,2017,19,6839,7182,14021
6013,CONTRA COSTA,2017,20,6473,6855,13328
6013,CONTRA COSTA,2017,21,6574,6962,13536
6013,CONTRA COSTA,2017,22,6347,6632,12979
6013,CONTRA COSTA,2017,23,6617,6967,13584
6013,CONTRA COSTA,2017,24,6891,7276,14167
6013,CONTRA COSTA,2017,25,6573,7050,13623
6013,CONTRA COSTA,2017,26,6326,6704,13030
6013,CONTRA COSTA,2017,27,6631,7058,13689
6013,CONTRA COSTA,2017,28,6602,6640,13242
6013,CONTRA COSTA,2017,29,6480,6951,13431
6013,CONTRA COSTA,2017,30,6830,7036,13866
6013,CONTRA COSTA,2017,31,7298,7359,14657
6013,CONTRA COSTA,2017,32,7753,7743,15496
6013,CONTRA COSTA,2017,33,7623,7682,15305
6013,CONTRA COSTA,2017,34,7954,7806,15760
6013,CONTRA COSTA,2017,35,7750,8002,15752
6013,CONTRA COSTA,2017,36,7808,7574,15382
6013,CONTRA COSTA,2017,37,8059,8068,16127
6013,CONTRA COSTA,2017,38,7475,7286,14761
6013,CONTRA COSTA,2017,39,7540,7267,14807
6013,CONTRA COSTA,2017,40,7562,7118,14680
6013,CONTRA COSTA,2017,41,7515,7073,14588
6013,CONTRA COSTA,2017,42,7523,7205,14728
6013,CONTRA COSTA,2017,43,7441,7277,14718
6013,CONTRA COSTA,2017,44,7729,7085,14814
6013,CONTRA COSTA,2017,45,7717,7372,15089
6013,CONTRA COSTA,2017,46,8122,7738,15860
6013,CONTRA COSTA,2017,47,8676,8283,16959
6013,CONTRA COSTA,2017,48,8328,7921,16249
6013,CONTRA COSTA,2017,49,8199,7587,15786
6013,CONTRA COSTA,2017,50,8092,7545,15637
6013,CONTRA COSTA,2017,51,8066,7770,15836
6013,CONTRA COSTA,2017,52,8599,8264,16863
6013,CONTRA COSTA,2017,53,8808,8153,16961
6013,CONTRA COSTA,2017,54,8797,8184,16981
6013,CONTRA COSTA,2017,55,8717,8245,16962
6013,CONTRA COSTA,2017,56,8780,8188,16968
6013,CONTRA COSTA,2017,57,8994,8396,17390
6013,CONTRA COSTA,2017,58,8343,7737,16080
6013,CONTRA COSTA,2017,59,8309,7612,15921
6013,CONTRA COSTA,2017,60,8134,7627,15761
6013,CONTRA COSTA,2017,61,7958,7311,15269
6013,CONTRA COSTA,2017,62,8011,7486,15497
6013,CONTRA COSTA,2017,63,7419,6881,14300
6013,CONTRA COSTA,2017,64,7419,6661,14080
6013,CONTRA COSTA,2017,65,7152,6290,13442
6013,CONTRA COSTA,2017,66,6853,6036,12889
6013,CONTRA COSTA,2017,67,6889,6057,12946
6013,CONTRA COSTA,2017,68,6492,5703,12195
6013,CONTRA COSTA,2017,69,6535,5619,12154
6013,CONTRA COSTA,2017,70,6541,5611,12152
6013,CONTRA COSTA,2017,71,5263,4403,9666
6013,CONTRA COSTA,2017,72,4845,4106,8951
6013,CONTRA COSTA,2017,73,4526,3721,8247
6013,CONTRA COSTA,2017,74,4353,3585,7938
6013,CONTRA COSTA,2017,75,3902,3137,7039
6013,CONTRA COSTA,2017,76,3411,2813,6224
6013,CONTRA COSTA,2017,77,3157,2552,5709
6013,CONTRA COSTA,2017,78,2988,2408,5396
6013,CONTRA COSTA,2017,79,2671,2190,4861
6013,CONTRA COSTA,2017,80,2674,2092,4766
6013,CONTRA COSTA,2017,81,2464,1852,4316
6013,CONTRA COSTA,2017,82,2356,1713,4069
6013,CONTRA COSTA,2017,83,2121,1422,3543
6013,CONTRA COSTA,2017,84,2037,1448,3485
6013,CONTRA COSTA,2017,85,2048,1328,3376
6013,CONTRA COSTA,2017,86,1998,1241,3239
6013,CONTRA COSTA,2017,87,1844,1095,2939
6013,CONTRA COSTA,2017,88,1590,936,2526
6013,CONTRA COSTA,2017,89,1453,855,2308
6013,CONTRA COSTA,2017,90,1385,693,2078
6013,CONTRA COSTA,2017,91,1183,548,1731
6013,CONTRA COSTA,2017,92,862,460,1322
6013,CONTRA COSTA,2017,93,690,355,1045
6013,CONTRA COSTA,2017,94,613,253,866
6013,CONTRA COSTA,2017,95,525,198,723
6013,CONTRA COSTA,2017,96,331,136,467
6013,CONTRA COSTA,2017,97,240,77,317
6013,CONTRA COSTA,2017,98,130,65,195
6013,CONTRA COSTA,2017,99,107,24,131
6013,CONTRA COSTA,2017,100,113,22,135
6013,CONTRA COSTA,2018,0,6289,6686,12975
6013,CONTRA COSTA,2018,1,6029,6721,12750
6013,CONTRA COSTA,2018,2,6277,6431,12708
6013,CONTRA COSTA,2018,3,6310,6587,12897
6013,CONTRA COSTA,2018,4,6255,6532,12787
6013,CONTRA COSTA,2018,5,6492,6516,13008
6013,CONTRA COSTA,2018,6,6283,6477,12760
6013,CONTRA COSTA,2018,7,6555,6796,13351
6013,CONTRA COSTA,2018,8,6604,6919,13523
6013,CONTRA COSTA,2018,9,6934,7153,14087
6013,CONTRA COSTA,2018,10,7329,7432,14761
6013,CONTRA COSTA,2018,11,7468,7788,15256
6013,CONTRA COSTA,2018,12,7459,7608,15067
6013,CONTRA COSTA,2018,13,7268,7890,15158
6013,CONTRA COSTA,2018,14,7386,7837,15223
6013,CONTRA COSTA,2018,15,7429,7754,15183
6013,CONTRA COSTA,2018,16,7360,7497,14857
6013,CONTRA COSTA,2018,17,7134,7400,14534
6013,CONTRA COSTA,2018,18,6983,7450,14433
6013,CONTRA COSTA,2018,19,6912,7127,14039
6013,CONTRA COSTA,2018,20,6512,6805,13317
6013,CONTRA COSTA,2018,21,6528,6890,13418
6013,CONTRA COSTA,2018,22,6657,7006,13663
6013,CONTRA COSTA,2018,23,6410,6686,13096
6013,CONTRA COSTA,2018,24,6712,7085,13797
6013,CONTRA COSTA,2018,25,6928,7277,14205
6013,CONTRA COSTA,2018,26,6766,7236,14002
6013,CONTRA COSTA,2018,27,6453,6848,13301
6013,CONTRA COSTA,2018,28,6831,7254,14085
6013,CONTRA COSTA,2018,29,6773,6826,13599
6013,CONTRA COSTA,2018,30,6673,7194,13867
6013,CONTRA COSTA,2018,31,7042,7224,14266
6013,CONTRA COSTA,2018,32,7431,7478,14909
6013,CONTRA COSTA,2018,33,7917,7928,15845
6013,CONTRA COSTA,2018,34,7774,7874,15648
6013,CONTRA COSTA,2018,35,8169,8024,16193
6013,CONTRA COSTA,2018,36,7841,8059,15900
6013,CONTRA COSTA,2018,37,7914,7703,15617
6013,CONTRA COSTA,2018,38,8164,8160,16324
6013,CONTRA COSTA,2018,39,7580,7417,14997
6013,CONTRA COSTA,2018,40,7662,7391,15053
6013,CONTRA COSTA,2018,41,7627,7152,14779
6013,CONTRA COSTA,2018,42,7573,7115,14688
6013,CONTRA COSTA,2018,43,7566,7257,14823
6013,CONTRA COSTA,2018,44,7512,7317,14829
6013,CONTRA COSTA,2018,45,7769,7128,14897
6013,CONTRA COSTA,2018,46,7748,7398,15146
6013,CONTRA COSTA,2018,47,8136,7759,15895
6013,CONTRA COSTA,2018,48,8699,8315,17014
6013,CONTRA COSTA,2018,49,8352,7946,16298
6013,CONTRA COSTA,2018,50,8198,7602,15800
6013,CONTRA COSTA,2018,51,8110,7558,15668
6013,CONTRA COSTA,2018,52,8079,7735,15814
6013,CONTRA COSTA,2018,53,8602,8262,16864
6013,CONTRA COSTA,2018,54,8840,8161,17001
6013,CONTRA COSTA,2018,55,8804,8198,17002
6013,CONTRA COSTA,2018,56,8734,8223,16957
6013,CONTRA COSTA,2018,57,8782,8144,16926
6013,CONTRA COSTA,2018,58,9023,8348,17371
6013,CONTRA COSTA,2018,59,8337,7707,16044
6013,CONTRA COSTA,2018,60,8308,7603,15911
6013,CONTRA COSTA,2018,61,8126,7632,15758
6013,CONTRA COSTA,2018,62,7992,7283,15275
6013,CONTRA COSTA,2018,63,8012,7460,15472
6013,CONTRA COSTA,2018,64,7443,6882,14325
6013,CONTRA COSTA,2018,65,7438,6646,14084
6013,CONTRA COSTA,2018,66,7114,6220,13334
6013,CONTRA COSTA,2018,67,6829,5990,12819
6013,CONTRA COSTA,2018,68,6910,5990,12900
6013,CONTRA COSTA,2018,69,6494,5627,12121
6013,CONTRA COSTA,2018,70,6504,5583,12087
6013,CONTRA COSTA,2018,71,6417,5481,11898
6013,CONTRA COSTA,2018,72,5187,4312,9499
6013,CONTRA COSTA,2018,73,4746,4010,8756
6013,CONTRA COSTA,2018,74,4457,3623,8080
6013,CONTRA COSTA,2018,75,4292,3502,7794
6013,CONTRA COSTA,2018,76,3812,3040,6852
6013,CONTRA COSTA,2018,77,3357,2717,6074
6013,CONTRA COSTA,2018,78,3095,2491,5586
6013,CONTRA COSTA,2018,79,2928,2316,5244
6013,CONTRA COSTA,2018,80,2660,2135,4795
6013,CONTRA COSTA,2018,81,2561,1982,4543
6013,CONTRA COSTA,2018,82,2384,1767,4151
6013,CONTRA COSTA,2018,83,2256,1629,3885
6013,CONTRA COSTA,2018,84,2042,1354,3396
6013,CONTRA COSTA,2018,85,2072,1413,3485
6013,CONTRA COSTA,2018,86,1929,1200,3129
6013,CONTRA COSTA,2018,87,1848,1122,2970
6013,CONTRA COSTA,2018,88,1702,1041,2743
6013,CONTRA COSTA,2018,89,1479,826,2305
6013,CONTRA COSTA,2018,90,1353,755,2108
6013,CONTRA COSTA,2018,91,1155,562,1717
6013,CONTRA COSTA,2018,92,1025,432,1457
6013,CONTRA COSTA,2018,93,711,368,1079
6013,CONTRA COSTA,2018,94,597,277,874
6013,CONTRA COSTA,2018,95,510,189,699
6013,CONTRA COSTA,2018,96,383,135,518
6013,CONTRA COSTA,2018,97,264,96,360
6013,CONTRA COSTA,2018,98,173,47,220
6013,CONTRA COSTA,2018,99,99,47,146
6013,CONTRA COSTA,2018,100,139,34,173
6013,CONTRA COSTA,2019,0,6349,6794,13143
6013,CONTRA COSTA,2019,1,6269,6667,12936
6013,CONTRA COSTA,2019,2,6129,6836,12965
6013,CONTRA COSTA,2019,3,6400,6537,12937
6013,CONTRA COSTA,2019,4,6401,6693,13094
6013,CONTRA COSTA,2019,5,6353,6601,12954
6013,CONTRA COSTA,2019,6,6550,6603,13153
6013,CONTRA COSTA,2019,7,6346,6566,12912
6013,CONTRA COSTA,2019,8,6620,6857,13477
6013,CONTRA COSTA,2019,9,6673,6953,13626
6013,CONTRA COSTA,2019,10,6983,7250,14233
6013,CONTRA COSTA,2019,11,7369,7484,14853
6013,CONTRA COSTA,2019,12,7518,7838,15356
6013,CONTRA COSTA,2019,13,7516,7639,15155
6013,CONTRA COSTA,2019,14,7276,7954,15230
6013,CONTRA COSTA,2019,15,7434,7882,15316
6013,CONTRA COSTA,2019,16,7241,7533,14774
6013,CONTRA COSTA,2019,17,7191,7346,14537
6013,CONTRA COSTA,2019,18,7138,7473,14611
6013,CONTRA COSTA,2019,19,6798,7270,14068
6013,CONTRA COSTA,2019,20,6576,6706,13282
6013,CONTRA COSTA,2019,21,6573,6844,13417
6013,CONTRA COSTA,2019,22,6596,6926,13522
6013,CONTRA COSTA,2019,23,6723,7057,13780
6013,CONTRA COSTA,2019,24,6527,6788,13315
6013,CONTRA COSTA,2019,25,6756,7094,13850
6013,CONTRA COSTA,2019,26,7118,7461,14579
6013,CONTRA COSTA,2019,27,6907,7363,14270
6013,CONTRA COSTA,2019,28,6660,7016,13676
6013,CONTRA COSTA,2019,29,7024,7434,14458
6013,CONTRA COSTA,2019,30,6968,7088,14056
6013,CONTRA COSTA,2019,31,6892,7384,14276
6013,CONTRA COSTA,2019,32,7189,7372,14561
6013,CONTRA COSTA,2019,33,7597,7673,15270
6013,CONTRA COSTA,2019,34,8084,8107,16191
6013,CONTRA COSTA,2019,35,7970,8064,16034
6013,CONTRA COSTA,2019,36,8294,8100,16394
6013,CONTRA COSTA,2019,37,7955,8201,16156
6013,CONTRA COSTA,2019,38,8010,7804,15814
6013,CONTRA COSTA,2019,39,8262,8277,16539
6013,CONTRA COSTA,2019,40,7669,7520,15189
6013,CONTRA COSTA,2019,41,7704,7448,15152
6013,CONTRA COSTA,2019,42,7686,7208,14894
6013,CONTRA COSTA,2019,43,7613,7172,14785
6013,CONTRA COSTA,2019,44,7634,7303,14937
6013,CONTRA COSTA,2019,45,7544,7378,14922
6013,CONTRA COSTA,2019,46,7805,7163,14968
6013,CONTRA COSTA,2019,47,7758,7407,15165
6013,CONTRA COSTA,2019,48,8152,7789,15941
6013,CONTRA COSTA,2019,49,8730,8334,17064
6013,CONTRA COSTA,2019,50,8366,7965,16331
6013,CONTRA COSTA,2019,51,8225,7632,15857
6013,CONTRA COSTA,2019,52,8122,7516,15638
6013,CONTRA COSTA,2019,53,8084,7718,15802
6013,CONTRA COSTA,2019,54,8617,8289,16906
6013,CONTRA COSTA,2019,55,8877,8146,17023
6013,CONTRA COSTA,2019,56,8798,8193,16991
6013,CONTRA COSTA,2019,57,8725,8189,16914
6013,CONTRA COSTA,2019,58,8827,8091,16918
6013,CONTRA COSTA,2019,59,9019,8321,17340
6013,CONTRA COSTA,2019,60,8353,7683,16036
6013,CONTRA COSTA,2019,61,8307,7596,15903
6013,CONTRA COSTA,2019,62,8149,7614,15763
6013,CONTRA COSTA,2019,63,7995,7267,15262
6013,CONTRA COSTA,2019,64,8032,7468,15500
6013,CONTRA COSTA,2019,65,7472,6882,14354
6013,CONTRA COSTA,2019,66,7405,6584,13989
6013,CONTRA COSTA,2019,67,7102,6183,13285
6013,CONTRA COSTA,2019,68,6838,5922,12760
6013,CONTRA COSTA,2019,69,6898,5925,12823
6013,CONTRA COSTA,2019,70,6480,5600,12080
6013,CONTRA COSTA,2019,71,6383,5469,11852
6013,CONTRA COSTA,2019,72,6327,5375,11702
6013,CONTRA COSTA,2019,73,5085,4206,9291
6013,CONTRA COSTA,2019,74,4669,3898,8567
6013,CONTRA COSTA,2019,75,4415,3554,7969
6013,CONTRA COSTA,2019,76,4193,3411,7604
6013,CONTRA COSTA,2019,77,3742,2950,6692
6013,CONTRA COSTA,2019,78,3292,2660,5952
6013,CONTRA COSTA,2019,79,3038,2392,5430
6013,CONTRA COSTA,2019,80,2911,2269,5180
6013,CONTRA COSTA,2019,81,2549,2020,4569
6013,CONTRA COSTA,2019,82,2478,1901,4379
6013,CONTRA COSTA,2019,83,2308,1684,3992
6013,CONTRA COSTA,2019,84,2164,1557,3721
6013,CONTRA COSTA,2019,85,2087,1309,3396
6013,CONTRA COSTA,2019,86,1983,1287,3270
6013,CONTRA COSTA,2019,87,1791,1081,2872
6013,CONTRA COSTA,2019,88,1689,1046,2735
6013,CONTRA COSTA,2019,89,1601,942,2543
6013,CONTRA COSTA,2019,90,1386,742,2128
6013,CONTRA COSTA,2019,91,1142,617,1759
6013,CONTRA COSTA,2019,92,977,448,1425
6013,CONTRA COSTA,2019,93,846,345,1191
6013,CONTRA COSTA,2019,94,627,295,922
6013,CONTRA COSTA,2019,95,502,212,714
6013,CONTRA COSTA,2019,96,375,133,508
6013,CONTRA COSTA,2019,97,287,94,381
6013,CONTRA COSTA,2019,98,196,57,253
6013,CONTRA COSTA,2019,99,138,28,166
6013,CONTRA COSTA,2019,100,162,58,220
6015,DEL NORTE,2017,0,146,166,312
6015,DEL NORTE,2017,1,166,146,312
6015,DEL NORTE,2017,2,139,165,304
6015,DEL NORTE,2017,3,169,144,313
6015,DEL NORTE,2017,4,151,177,328
6015,DEL NORTE,2017,5,167,156,323
6015,DEL NORTE,2017,6,163,177,340
6015,DEL NORTE,2017,7,171,179,350
6015,DEL NORTE,2017,8,134,161,295
6015,DEL NORTE,2017,9,195,156,351
6015,DEL NORTE,2017,10,191,172,363
6015,DEL NORTE,2017,11,161,179,340
6015,DEL NORTE,2017,12,147,144,291
6015,DEL NORTE,2017,13,136,168,304
6015,DEL NORTE,2017,14,144,149,293
6015,DEL NORTE,2017,15,135,175,310
6015,DEL NORTE,2017,16,174,160,334
6015,DEL NORTE,2017,17,178,170,348
6015,DEL NORTE,2017,18,168,185,353
6015,DEL NORTE,2017,19,186,194,380
6015,DEL NORTE,2017,20,177,245,422
6015,DEL NORTE,2017,21,130,240,370
6015,DEL NORTE,2017,22,156,198,354
6015,DEL NORTE,2017,23,180,222,402
6015,DEL NORTE,2017,24,168,240,408
6015,DEL NORTE,2017,25,141,240,381
6015,DEL NORTE,2017,26,132,217,349
6015,DEL NORTE,2017,27,126,206,332
6015,DEL NORTE,2017,28,121,189,310
6015,DEL NORTE,2017,29,111,198,309
6015,DEL NORTE,2017,30,114,231,345
6015,DEL NORTE,2017,31,97,208,305
6015,DEL NORTE,2017,32,132,205,337
6015,DEL NORTE,2017,33,116,221,337
6015,DEL NORTE,2017,34,119,193,312
6015,DEL NORTE,2017,35,131,235,366
6015,DEL NORTE,2017,36,130,258,388
6015,DEL NORTE,2017,37,157,227,384
6015,DEL NORTE,2017,38,116,200,316
6015,DEL NORTE,2017,39,109,199,308
6015,DEL NORTE,2017,40,114,197,311
6015,DEL NORTE,2017,41,112,198,310
6015,DEL NORTE,2017,42,109,171,280
6015,DEL NORTE,2017,43,103,170,273
6015,DEL NORTE,2017,44,118,162,280
6015,DEL NORTE,2017,45,122,167,289
6015,DEL NORTE,2017,46,127,197,324
6015,DEL NORTE,2017,47,111,188,299
6015,DEL NORTE,2017,48,143,159,302
6015,DEL NORTE,2017,49,114,180,294
6015,DEL NORTE,2017,50,136,166,302
6015,DEL NORTE,2017,51,143,172,315
6015,DEL NORTE,2017,52,167,187,354
6015,DEL NORTE,2017,53,197,210,407
6015,DEL NORTE,2017,54,168,194,362
6015,DEL NORTE,2017,55,208,198,406
6015,DEL NORTE,2017,56,194,173,367
6015,DEL NORTE,2017,57,179,217,396
6015,DEL NORTE,2017,58,202,202,404
6015,DEL NORTE,2017,59,211,198,409
6015,DEL NORTE,2017,60,220,173,393
6015,DEL NORTE,2017,61,218,179,397
6015,DEL NORTE,2017,62,215,187,402
6015,DEL NORTE,2017,63,189,168,357
6015,DEL NORTE,2017,64,181,160,341
6015,DEL NORTE,2017,65,185,161,346
6015,DEL NORTE,2017,66,151,151,302
6015,DEL NORTE,2017,67,185,165,350
6015,DEL NORTE,2017,68,140,172,312
6015,DEL NORTE,2017,69,154,169,323
6015,DEL NORTE,2017,70,147,161,308
6015,DEL NORTE,2017,71,154,119,273
6015,DEL NORTE,2017,72,118,110,228
6015,DEL NORTE,2017,73,115,106,221
6015,DEL NORTE,2017,74,142,117,259
6015,DEL NORTE,2017,75,100,100,200
6015,DEL NORTE,2017,76,81,89,170
6015,DEL NORTE,2017,77,94,98,192
6015,DEL NORTE,2017,78,91,73,164
6015,DEL NORTE,2017,79,76,56,132
6015,DEL NORTE,2017,80,78,51,129
6015,DEL NORTE,2017,81,72,39,111
6015,DEL NORTE,2017,82,55,40,95
6015,DEL NORTE,2017,83,54,48,102
6015,DEL NORTE,2017,84,46,48,94
6015,DEL NORTE,2017,85,79,52,131
6015,DEL NORTE,2017,86,55,34,89
6015,DEL NORTE,2017,87,45,21,66
6015,DEL NORTE,2017,88,45,30,75
6015,DEL NORTE,2017,89,26,22,48
6015,DEL NORTE,2017,90,36,14,50
6015,DEL NORTE,2017,91,33,7,40
6015,DEL NORTE,2017,92,18,11,29
6015,DEL NORTE,2017,93,16,3,19
6015,DEL NORTE,2017,94,7,5,12
6015,DEL NORTE,2017,95,5,10,15
6015,DEL NORTE,2017,96,8,1,9
6015,DEL NORTE,2017,97,3,5,8
6015,DEL NORTE,2017,98,4,0,4
6015,DEL NORTE,2017,99,2,0,2
6015,DEL NORTE,2017,100,2,0,2
6015,DEL NORTE,2018,0,152,165,317
6015,DEL NORTE,2018,1,145,165,310
6015,DEL NORTE,2018,2,166,147,313
6015,DEL NORTE,2018,3,140,164,304
6015,DEL NORTE,2018,4,170,144,314
6015,DEL NORTE,2018,5,149,177,326
6015,DEL NORTE,2018,6,167,157,324
6015,DEL NORTE,2018,7,163,177,340
6015,DEL NORTE,2018,8,171,181,352
6015,DEL NORTE,2018,9,135,159,294
6015,DEL NORTE,2018,10,194,156,350
6015,DEL NORTE,2018,11,191,173,364
6015,DEL NORTE,2018,12,162,178,340
6015,DEL NORTE,2018,13,146,144,290
6015,DEL NORTE,2018,14,137,168,305
6015,DEL NORTE,2018,15,144,150,294
6015,DEL NORTE,2018,16,136,174,310
6015,DEL NORTE,2018,17,176,165,341
6015,DEL NORTE,2018,18,182,183,365
6015,DEL NORTE,2018,19,163,205,368
6015,DEL NORTE,2018,20,187,216,403
6015,DEL NORTE,2018,21,176,250,426
6015,DEL NORTE,2018,22,132,225,357
6015,DEL NORTE,2018,23,154,217,371
6015,DEL NORTE,2018,24,179,219,398
6015,DEL NORTE,2018,25,167,249,416
6015,DEL NORTE,2018,26,142,233,375
6015,DEL NORTE,2018,27,133,238,371
6015,DEL NORTE,2018,28,126,204,330
6015,DEL NORTE,2018,29,123,201,324
6015,DEL NORTE,2018,30,108,220,328
6015,DEL NORTE,2018,31,113,206,319
6015,DEL NORTE,2018,32,99,210,309
6015,DEL NORTE,2018,33,130,211,341
6015,DEL NORTE,2018,34,117,201,318
6015,DEL NORTE,2018,35,117,223,340
6015,DEL NORTE,2018,36,130,219,349
6015,DEL NORTE,2018,37,129,255,384
6015,DEL NORTE,2018,38,157,229,386
6015,DEL NORTE,2018,39,116,180,296
6015,DEL NORTE,2018,40,110,203,313
6015,DEL NORTE,2018,41,114,194,308
6015,DEL NORTE,2018,42,112,187,299
6015,DEL NORTE,2018,43,109,167,276
6015,DEL NORTE,2018,44,106,169,275
6015,DEL NORTE,2018,45,116,157,273
6015,DEL NORTE,2018,46,123,169,292
6015,DEL NORTE,2018,47,125,186,311
6015,DEL NORTE,2018,48,110,184,294
6015,DEL NORTE,2018,49,144,168,312
6015,DEL NORTE,2018,50,114,157,271
6015,DEL NORTE,2018,51,137,166,303
6015,DEL NORTE,2018,52,141,167,308
6015,DEL NORTE,2018,53,164,179,343
6015,DEL NORTE,2018,54,197,201,398
6015,DEL NORTE,2018,55,165,191,356
6015,DEL NORTE,2018,56,208,200,408
6015,DEL NORTE,2018,57,191,162,353
6015,DEL NORTE,2018,58,180,216,396
6015,DEL NORTE,2018,59,196,192,388
6015,DEL NORTE,2018,60,207,202,409
6015,DEL NORTE,2018,61,219,174,393
6015,DEL NORTE,2018,62,218,170,388
6015,DEL NORTE,2018,63,213,184,397
6015,DEL NORTE,2018,64,187,163,350
6015,DEL NORTE,2018,65,179,155,334
6015,DEL NORTE,2018,66,180,159,339
6015,DEL NORTE,2018,67,150,146,296
6015,DEL NORTE,2018,68,180,163,343
6015,DEL NORTE,2018,69,137,170,307
6015,DEL NORTE,2018,70,151,162,313
6015,DEL NORTE,2018,71,145,154,299
6015,DEL NORTE,2018,72,150,115,265
6015,DEL NORTE,2018,73,115,105,220
6015,DEL NORTE,2018,74,112,102,214
6015,DEL NORTE,2018,75,142,112,254
6015,DEL NORTE,2018,76,98,94,192
6015,DEL NORTE,2018,77,78,85,163
6015,DEL NORTE,2018,78,89,95,184
6015,DEL NORTE,2018,79,88,72,160
6015,DEL NORTE,2018,80,74,57,131
6015,DEL NORTE,2018,81,78,48,126
6015,DEL NORTE,2018,82,70,32,102
6015,DEL NORTE,2018,83,55,33,88
6015,DEL NORTE,2018,84,47,44,91
6015,DEL NORTE,2018,85,49,48,97
6015,DEL NORTE,2018,86,70,43,113
6015,DEL NORTE,2018,87,50,27,77
6015,DEL NORTE,2018,88,45,19,64
6015,DEL NORTE,2018,89,40,28,68
6015,DEL NORTE,2018,90,25,19,44
6015,DEL NORTE,2018,91,25,9,34
6015,DEL NORTE,2018,92,29,6,35
6015,DEL NORTE,2018,93,11,8,19
6015,DEL NORTE,2018,94,13,4,17
6015,DEL NORTE,2018,95,6,3,9
6015,DEL NORTE,2018,96,4,9,13
6015,DEL NORTE,2018,97,5,1,6
6015,DEL NORTE,2018,98,4,3,7
6015,DEL NORTE,2018,99,3,0,3
6015,DEL NORTE,2018,100,3,0,3
6015,DEL NORTE,2019,0,152,166,318
6015,DEL NORTE,2019,1,150,165,315
6015,DEL NORTE,2019,2,145,166,311
6015,DEL NORTE,2019,3,168,146,314
6015,DEL NORTE,2019,4,141,164,305
6015,DEL NORTE,2019,5,168,143,311
6015,DEL NORTE,2019,6,149,177,326
6015,DEL NORTE,2019,7,167,157,324
6015,DEL NORTE,2019,8,164,179,343
6015,DEL NORTE,2019,9,172,179,351
6015,DEL NORTE,2019,10,134,159,293
6015,DEL NORTE,2019,11,194,157,351
6015,DEL NORTE,2019,12,192,172,364
6015,DEL NORTE,2019,13,162,178,340
6015,DEL NORTE,2019,14,147,144,291
6015,DEL NORTE,2019,15,136,171,307
6015,DEL NORTE,2019,16,143,150,293
6015,DEL NORTE,2019,17,138,176,314
6015,DEL NORTE,2019,18,178,181,359
6015,DEL NORTE,2019,19,179,203,382
6015,DEL NORTE,2019,20,166,224,390
6015,DEL NORTE,2019,21,185,221,406
6015,DEL NORTE,2019,22,177,235,412
6015,DEL NORTE,2019,23,131,244,375
6015,DEL NORTE,2019,24,153,215,368
6015,DEL NORTE,2019,25,178,226,404
6015,DEL NORTE,2019,26,169,243,412
6015,DEL NORTE,2019,27,142,254,396
6015,DEL NORTE,2019,28,134,235,369
6015,DEL NORTE,2019,29,128,216,344
6015,DEL NORTE,2019,30,120,223,343
6015,DEL NORTE,2019,31,108,195,303
6015,DEL NORTE,2019,32,115,208,323
6015,DEL NORTE,2019,33,97,216,313
6015,DEL NORTE,2019,34,132,191,323
6015,DEL NORTE,2019,35,117,231,348
6015,DEL NORTE,2019,36,117,207,324
6015,DEL NORTE,2019,37,130,215,345
6015,DEL NORTE,2019,38,129,257,386
6015,DEL NORTE,2019,39,158,210,368
6015,DEL NORTE,2019,40,117,184,301
6015,DEL NORTE,2019,41,110,201,311
6015,DEL NORTE,2019,42,114,183,297
6015,DEL NORTE,2019,43,111,182,293
6015,DEL NORTE,2019,44,112,166,278
6015,DEL NORTE,2019,45,104,165,269
6015,DEL NORTE,2019,46,115,160,275
6015,DEL NORTE,2019,47,120,157,277
6015,DEL NORTE,2019,48,124,182,306
6015,DEL NORTE,2019,49,111,195,306
6015,DEL NORTE,2019,50,142,147,289
6015,DEL NORTE,2019,51,116,157,273
6015,DEL NORTE,2019,52,135,162,297
6015,DEL NORTE,2019,53,139,158,297
6015,DEL NORTE,2019,54,165,170,335
6015,DEL NORTE,2019,55,195,198,393
6015,DEL NORTE,2019,56,161,193,354
6015,DEL NORTE,2019,57,205,189,394
6015,DEL NORTE,2019,58,192,161,353
6015,DEL NORTE,2019,59,179,206,385
6015,DEL NORTE,2019,60,194,196,390
6015,DEL NORTE,2019,61,204,199,403
6015,DEL NORTE,2019,62,215,163,378
6015,DEL NORTE,2019,63,215,172,387
6015,DEL NORTE,2019,64,209,180,389
6015,DEL NORTE,2019,65,186,160,346
6015,DEL NORTE,2019,66,177,151,328
6015,DEL NORTE,2019,67,170,155,325
6015,DEL NORTE,2019,68,148,148,296
6015,DEL NORTE,2019,69,172,159,331
6015,DEL NORTE,2019,70,137,166,303
6015,DEL NORTE,2019,71,152,158,310
6015,DEL NORTE,2019,72,141,154,295
6015,DEL NORTE,2019,73,150,110,260
6015,DEL NORTE,2019,74,111,105,216
6015,DEL NORTE,2019,75,112,101,213
6015,DEL NORTE,2019,76,134,105,239
6015,DEL NORTE,2019,77,94,90,184
6015,DEL NORTE,2019,78,70,81,151
6015,DEL NORTE,2019,79,86,92,178
6015,DEL NORTE,2019,80,85,69,154
6015,DEL NORTE,2019,81,72,52,124
6015,DEL NORTE,2019,82,73,43,116
6015,DEL NORTE,2019,83,68,30,98
6015,DEL NORTE,2019,84,49,29,78
6015,DEL NORTE,2019,85,52,40,92
6015,DEL NORTE,2019,86,44,46,90
6015,DEL NORTE,2019,87,63,38,101
6015,DEL NORTE,2019,88,48,22,70
6015,DEL NORTE,2019,89,39,18,57
6015,DEL NORTE,2019,90,37,23,60
6015,DEL NORTE,2019,91,18,12,30
6015,DEL NORTE,2019,92,22,8,30
6015,DEL NORTE,2019,93,21,4,25
6015,DEL NORTE,2019,94,9,7,16
6015,DEL NORTE,2019,95,11,3,14
6015,DEL NORTE,2019,96,5,2,7
6015,DEL NORTE,2019,97,3,5,8
6015,DEL NORTE,2019,98,6,0,6
6015,DEL NORTE,2019,99,3,3,6
6015,DEL NORTE,2019,100,4,0,4
6017,EL DORADO,2017,0,746,825,1571
6017,EL DORADO,2017,1,735,815,1550
6017,EL DORADO,2017,2,813,790,1603
6017,EL DORADO,2017,3,744,847,1591
6017,EL DORADO,2017,4,742,760,1502
6017,EL DORADO,2017,5,769,815,1584
6017,EL DORADO,2017,6,814,819,1633
6017,EL DORADO,2017,7,789,870,1659
6017,EL DORADO,2017,8,881,973,1854
6017,EL DORADO,2017,9,956,1064,2020
6017,EL DORADO,2017,10,1021,1190,2211
6017,EL DORADO,2017,11,1150,1223,2373
6017,EL DORADO,2017,12,1101,1253,2354
6017,EL DORADO,2017,13,1150,1294,2444
6017,EL DORADO,2017,14,1215,1292,2507
6017,EL DORADO,2017,15,1252,1335,2587
6017,EL DORADO,2017,16,1217,1287,2504
6017,EL DORADO,2017,17,1279,1338,2617
6017,EL DORADO,2017,18,1242,1305,2547
6017,EL DORADO,2017,19,1251,1376,2627
6017,EL DORADO,2017,20,1283,1333,2616
6017,EL DORADO,2017,21,1292,1381,2673
6017,EL DORADO,2017,22,1240,1354,2594
6017,EL DORADO,2017,23,1321,1334,2655
6017,EL DORADO,2017,24,1208,1370,2578
6017,EL DORADO,2017,25,1132,1270,2402
6017,EL DORADO,2017,26,991,1108,2099
6017,EL DORADO,2017,27,886,1081,1967
6017,EL DORADO,2017,28,798,936,1734
6017,EL DORADO,2017,29,789,965,1754
6017,EL DORADO,2017,30,791,900,1691
6017,EL DORADO,2017,31,810,980,1790
6017,EL DORADO,2017,32,777,934,1711
6017,EL DORADO,2017,33,886,972,1858
6017,EL DORADO,2017,34,854,890,1744
6017,EL DORADO,2017,35,847,970,1817
6017,EL DORADO,2017,36,887,939,1826
6017,EL DORADO,2017,37,925,1007,1932
6017,EL DORADO,2017,38,854,923,1777
6017,EL DORADO,2017,39,902,935,1837
6017,EL DORADO,2017,40,897,895,1792
6017,EL DORADO,2017,41,850,882,1732
6017,EL DORADO,2017,42,941,964,1905
6017,EL DORADO,2017,43,904,904,1808
6017,EL DORADO,2017,44,956,929,1885
6017,EL DORADO,2017,45,1025,1013,2038
6017,EL DORADO,2017,46,1122,1119,2241
6017,EL DORADO,2017,47,1220,1137,2357
6017,EL DORADO,2017,48,1175,1147,2322
6017,EL DORADO,2017,49,1142,1101,2243
6017,EL DORADO,2017,50,1217,1119,2336
6017,EL DORADO,2017,51,1217,1191,2408
6017,EL DORADO,2017,52,1405,1311,2716
6017,EL DORADO,2017,53,1386,1325,2711
6017,EL DORADO,2017,54,1580,1469,3049
6017,EL DORADO,2017,55,1603,1561,3164
6017,EL DORADO,2017,56,1693,1510,3203
6017,EL DORADO,2017,57,1585,1540,3125
6017,EL DORADO,2017,58,1662,1569,3231
6017,EL DORADO,2017,59,1666,1630,3296
6017,EL DORADO,2017,60,1715,1568,3283
6017,EL DORADO,2017,61,1498,1522,3020
6017,EL DORADO,2017,62,1597,1418,3015
6017,EL DORADO,2017,63,1497,1441,2938
6017,EL DORADO,2017,64,1505,1339,2844
6017,EL DORADO,2017,65,1404,1384,2788
6017,EL DORADO,2017,66,1330,1366,2696
6017,EL DORADO,2017,67,1315,1306,2621
6017,EL DORADO,2017,68,1217,1232,2449
6017,EL DORADO,2017,69,1253,1242,2495
6017,EL DORADO,2017,70,1319,1234,2553
6017,EL DORADO,2017,71,995,1012,2007
6017,EL DORADO,2017,72,944,927,1871
6017,EL DORADO,2017,73,868,855,1723
6017,EL DORADO,2017,74,1003,875,1878
6017,EL DORADO,2017,75,832,806,1638
6017,EL DORADO,2017,76,747,676,1423
6017,EL DORADO,2017,77,704,669,1373
6017,EL DORADO,2017,78,649,585,1234
6017,EL DORADO,2017,79,591,598,1189
6017,EL DORADO,2017,80,541,451,992
6017,EL DORADO,2017,81,443,428,871
6017,EL DORADO,2017,82,404,403,807
6017,EL DORADO,2017,83,400,318,718
6017,EL DORADO,2017,84,364,335,699
6017,EL DORADO,2017,85,376,305,681
6017,EL DORADO,2017,86,331,279,610
6017,EL DORADO,2017,87,286,221,507
6017,EL DORADO,2017,88,244,202,446
6017,EL DORADO,2017,89,242,136,378
6017,EL DORADO,2017,90,223,151,374
6017,EL DORADO,2017,91,177,77,254
6017,EL DORADO,2017,92,114,82,196
6017,EL DORADO,2017,93,100,63,163
6017,EL DORADO,2017,94,85,41,126
6017,EL DORADO,2017,95,72,36,108
6017,EL DORADO,2017,96,45,7,52
6017,EL DORADO,2017,97,44,10,54
6017,EL DORADO,2017,98,14,8,22
6017,EL DORADO,2017,99,9,10,19
6017,EL DORADO,2017,100,13,7,20
6017,EL DORADO,2018,0,788,815,1603
6017,EL DORADO,2018,1,747,826,1573
6017,EL DORADO,2018,2,732,814,1546
6017,EL DORADO,2018,3,816,791,1607
6017,EL DORADO,2018,4,750,850,1600
6017,EL DORADO,2018,5,743,760,1503
6017,EL DORADO,2018,6,777,844,1621
6017,EL DORADO,2018,7,819,860,1679
6017,EL DORADO,2018,8,820,895,1715
6017,EL DORADO,2018,9,911,1015,1926
6017,EL DORADO,2018,10,975,1109,2084
6017,EL DORADO,2018,11,1028,1222,2250
6017,EL DORADO,2018,12,1154,1241,2395
6017,EL DORADO,2018,13,1137,1290,2427
6017,EL DORADO,2018,14,1183,1308,2491
6017,EL DORADO,2018,15,1238,1334,2572
6017,EL DORADO,2018,16,1260,1335,2595
6017,EL DORADO,2018,17,1225,1301,2526
6017,EL DORADO,2018,18,1275,1335,2610
6017,EL DORADO,2018,19,1259,1372,2631
6017,EL DORADO,2018,20,1253,1351,2604
6017,EL DORADO,2018,21,1283,1327,2610
6017,EL DORADO,2018,22,1291,1390,2681
6017,EL DORADO,2018,23,1242,1344,2586
6017,EL DORADO,2018,24,1317,1337,2654
6017,EL DORADO,2018,25,1209,1351,2560
6017,EL DORADO,2018,26,1147,1275,2422
6017,EL DORADO,2018,27,990,1101,2091
6017,EL DORADO,2018,28,883,1082,1965
6017,EL DORADO,2018,29,804,946,1750
6017,EL DORADO,2018,30,785,956,1741
6017,EL DORADO,2018,31,819,937,1756
6017,EL DORADO,2018,32,812,992,1804
6017,EL DORADO,2018,33,792,944,1736
6017,EL DORADO,2018,34,903,988,1891
6017,EL DORADO,2018,35,863,925,1788
6017,EL DORADO,2018,36,856,982,1838
6017,EL DORADO,2018,37,892,951,1843
6017,EL DORADO,2018,38,929,1007,1936
6017,EL DORADO,2018,39,862,938,1800
6017,EL DORADO,2018,40,905,945,1850
6017,EL DORADO,2018,41,889,903,1792
6017,EL DORADO,2018,42,863,876,1739
6017,EL DORADO,2018,43,944,969,1913
6017,EL DORADO,2018,44,907,895,1802
6017,EL DORADO,2018,45,961,951,1912
6017,EL DORADO,2018,46,1027,1008,2035
6017,EL DORADO,2018,47,1123,1126,2249
6017,EL DORADO,2018,48,1215,1126,2341
6017,EL DORADO,2018,49,1178,1152,2330
6017,EL DORADO,2018,50,1144,1090,2234
6017,EL DORADO,2018,51,1204,1098,2302
6017,EL DORADO,2018,52,1219,1192,2411
6017,EL DORADO,2018,53,1391,1303,2694
6017,EL DORADO,2018,54,1376,1326,2702
6017,EL DORADO,2018,55,1574,1462,3036
6017,EL DORADO,2018,56,1591,1545,3136
6017,EL DORADO,2018,57,1672,1491,3163
6017,EL DORADO,2018,58,1575,1528,3103
6017,EL DORADO,2018,59,1658,1554,3212
6017,EL DORADO,2018,60,1653,1616,3269
6017,EL DORADO,2018,61,1706,1555,3261
6017,EL DORADO,2018,62,1487,1504,2991
6017,EL DORADO,2018,63,1581,1400,2981
6017,EL DORADO,2018,64,1488,1419,2907
6017,EL DORADO,2018,65,1498,1324,2822
6017,EL DORADO,2018,66,1390,1362,2752
6017,EL DORADO,2018,67,1316,1352,2668
6017,EL DORADO,2018,68,1295,1277,2572
6017,EL DORADO,2018,69,1208,1210,2418
6017,EL DORADO,2018,70,1241,1226,2467
6017,EL DORADO,2018,71,1310,1233,2543
6017,EL DORADO,2018,72,983,994,1977
6017,EL DORADO,2018,73,939,927,1866
6017,EL DORADO,2018,74,874,862,1736
6017,EL DORADO,2018,75,1021,861,1882
6017,EL DORADO,2018,76,808,785,1593
6017,EL DORADO,2018,77,727,659,1386
6017,EL DORADO,2018,78,686,649,1335
6017,EL DORADO,2018,79,632,563,1195
6017,EL DORADO,2018,80,577,582,1159
6017,EL DORADO,2018,81,524,426,950
6017,EL DORADO,2018,82,428,406,834
6017,EL DORADO,2018,83,385,382,767
6017,EL DORADO,2018,84,382,300,682
6017,EL DORADO,2018,85,371,315,686
6017,EL DORADO,2018,86,356,284,640
6017,EL DORADO,2018,87,290,258,548
6017,EL DORADO,2018,88,270,193,463
6017,EL DORADO,2018,89,233,186,419
6017,EL DORADO,2018,90,228,115,343
6017,EL DORADO,2018,91,196,126,322
6017,EL DORADO,2018,92,138,61,199
6017,EL DORADO,2018,93,107,64,171
6017,EL DORADO,2018,94,80,46,126
6017,EL DORADO,2018,95,68,32,100
6017,EL DORADO,2018,96,53,22,75
6017,EL DORADO,2018,97,38,7,45
6017,EL DORADO,2018,98,33,4,37
6017,EL DORADO,2018,99,10,4,14
6017,EL DORADO,2018,100,19,13,32
6017,EL DORADO,2019,0,758,838,1596
6017,EL DORADO,2019,1,789,814,1603
6017,EL DORADO,2019,2,745,831,1576
6017,EL DORADO,2019,3,733,817,1550
6017,EL DORADO,2019,4,821,796,1617
6017,EL DORADO,2019,5,751,847,1598
6017,EL DORADO,2019,6,747,785,1532
6017,EL DORADO,2019,7,782,878,1660
6017,EL DORADO,2019,8,861,895,1756
6017,EL DORADO,2019,9,856,929,1785
6017,EL DORADO,2019,10,938,1061,1999
6017,EL DORADO,2019,11,989,1147,2136
6017,EL DORADO,2019,12,1032,1238,2270
6017,EL DORADO,2019,13,1181,1276,2457
6017,EL DORADO,2019,14,1168,1312,2480
6017,EL DORADO,2019,15,1212,1348,2560
6017,EL DORADO,2019,16,1243,1331,2574
6017,EL DORADO,2019,17,1264,1357,2621
6017,EL DORADO,2019,18,1222,1295,2517
6017,EL DORADO,2019,19,1293,1405,2698
6017,EL DORADO,2019,20,1261,1358,2619
6017,EL DORADO,2019,21,1251,1343,2594
6017,EL DORADO,2019,22,1282,1338,2620
6017,EL DORADO,2019,23,1292,1383,2675
6017,EL DORADO,2019,24,1238,1347,2585
6017,EL DORADO,2019,25,1314,1318,2632
6017,EL DORADO,2019,26,1224,1358,2582
6017,EL DORADO,2019,27,1148,1267,2415
6017,EL DORADO,2019,28,987,1102,2089
6017,EL DORADO,2019,29,893,1090,1983
6017,EL DORADO,2019,30,802,936,1738
6017,EL DORADO,2019,31,809,994,1803
6017,EL DORADO,2019,32,827,951,1778
6017,EL DORADO,2019,33,830,1009,1839
6017,EL DORADO,2019,34,814,969,1783
6017,EL DORADO,2019,35,911,1002,1913
6017,EL DORADO,2019,36,874,936,1810
6017,EL DORADO,2019,37,858,1003,1861
6017,EL DORADO,2019,38,897,947,1844
6017,EL DORADO,2019,39,940,1019,1959
6017,EL DORADO,2019,40,866,948,1814
6017,EL DORADO,2019,41,902,953,1855
6017,EL DORADO,2019,42,908,898,1806
6017,EL DORADO,2019,43,870,888,1758
6017,EL DORADO,2019,44,945,965,1910
6017,EL DORADO,2019,45,911,914,1825
6017,EL DORADO,2019,46,963,949,1912
6017,EL DORADO,2019,47,1029,1014,2043
6017,EL DORADO,2019,48,1114,1119,2233
6017,EL DORADO,2019,49,1216,1130,2346
6017,EL DORADO,2019,50,1177,1141,2318
6017,EL DORADO,2019,51,1133,1078,2211
6017,EL DORADO,2019,52,1206,1094,2300
6017,EL DORADO,2019,53,1211,1183,2394
6017,EL DORADO,2019,54,1381,1303,2684
6017,EL DORADO,2019,55,1372,1320,2692
6017,EL DORADO,2019,56,1568,1441,3009
6017,EL DORADO,2019,57,1577,1525,3102
6017,EL DORADO,2019,58,1666,1478,3144
6017,EL DORADO,2019,59,1569,1511,3080
6017,EL DORADO,2019,60,1641,1535,3176
6017,EL DORADO,2019,61,1640,1604,3244
6017,EL DORADO,2019,62,1700,1541,3241
6017,EL DORADO,2019,63,1480,1488,2968
6017,EL DORADO,2019,64,1568,1382,2950
6017,EL DORADO,2019,65,1477,1398,2875
6017,EL DORADO,2019,66,1490,1298,2788
6017,EL DORADO,2019,67,1381,1345,2726
6017,EL DORADO,2019,68,1305,1334,2639
6017,EL DORADO,2019,69,1282,1257,2539
6017,EL DORADO,2019,70,1206,1195,2401
6017,EL DORADO,2019,71,1229,1231,2460
6017,EL DORADO,2019,72,1301,1207,2508
6017,EL DORADO,2019,73,975,987,1962
6017,EL DORADO,2019,74,942,919,1861
6017,EL DORADO,2019,75,882,853,1735
6017,EL DORADO,2019,76,988,830,1818
6017,EL DORADO,2019,77,787,756,1543
6017,EL DORADO,2019,78,712,645,1357
6017,EL DORADO,2019,79,675,634,1309
6017,EL DORADO,2019,80,611,547,1158
6017,EL DORADO,2019,81,555,553,1108
6017,EL DORADO,2019,82,505,404,909
6017,EL DORADO,2019,83,404,388,792
6017,EL DORADO,2019,84,371,359,730
6017,EL DORADO,2019,85,383,288,671
6017,EL DORADO,2019,86,342,292,634
6017,EL DORADO,2019,87,310,256,566
6017,EL DORADO,2019,88,266,234,500
6017,EL DORADO,2019,89,257,178,435
6017,EL DORADO,2019,90,214,164,378
6017,EL DORADO,2019,91,190,86,276
6017,EL DORADO,2019,92,148,110,258
6017,EL DORADO,2019,93,118,47,165
6017,EL DORADO,2019,94,82,44,126
6017,EL DORADO,2019,95,67,37,104
6017,EL DORADO,2019,96,49,24,73
6017,EL DORADO,2019,97,39,13,52
6017,EL DORADO,2019,98,30,5,35
6017,EL DORADO,2019,99,26,4,30
6017,EL DORADO,2019,100,21,6,27
6019,FRESNO,2017,0,7140,7912,15052
6019,FRESNO,2017,1,7393,7621,15014
6019,FRESNO,2017,2,7797,7833,15630
6019,FRESNO,2017,3,7840,8186,16026
6019,FRESNO,2017,4,7874,8116,15990
6019,FRESNO,2017,5,7879,8433,16312
6019,FRESNO,2017,6,8148,8399,16547
6019,FRESNO,2017,7,7795,7991,15786
6019,FRESNO,2017,8,7643,7847,15490
6019,FRESNO,2017,9,7901,8356,16257
6019,FRESNO,2017,10,7823,8371,16194
6019,FRESNO,2017,11,7676,8160,15836
6019,FRESNO,2017,12,7480,7882,15362
6019,FRESNO,2017,13,7481,7783,15264
6019,FRESNO,2017,14,7366,7617,14983
6019,FRESNO,2017,15,7245,7487,14732
6019,FRESNO,2017,16,7333,7617,14950
6019,FRESNO,2017,17,7516,7777,15293
6019,FRESNO,2017,18,8775,9215,17990
6019,FRESNO,2017,19,9170,9577,18747
6019,FRESNO,2017,20,9121,9751,18872
6019,FRESNO,2017,21,8911,9423,18334
6019,FRESNO,2017,22,8373,9240,17613
6019,FRESNO,2017,23,8430,9038,17468
6019,FRESNO,2017,24,8075,8708,16783
6019,FRESNO,2017,25,7801,8265,16066
6019,FRESNO,2017,26,6636,6934,13570
6019,FRESNO,2017,27,6072,6488,12560
6019,FRESNO,2017,28,6112,6229,12341
6019,FRESNO,2017,29,6125,6588,12713
6019,FRESNO,2017,30,6214,6653,12867
6019,FRESNO,2017,31,6339,6983,13322
6019,FRESNO,2017,32,6334,6774,13108
6019,FRESNO,2017,33,6543,6887,13430
6019,FRESNO,2017,34,6967,7238,14205
6019,FRESNO,2017,35,6858,7071,13929
6019,FRESNO,2017,36,6757,6910,13667
6019,FRESNO,2017,37,6485,6804,13289
6019,FRESNO,2017,38,6123,6331,12454
6019,FRESNO,2017,39,5993,6093,12086
6019,FRESNO,2017,40,5821,5923,11744
6019,FRESNO,2017,41,5676,5951,11627
6019,FRESNO,2017,42,5724,5930,11654
6019,FRESNO,2017,43,5401,5747,11148
6019,FRESNO,2017,44,5561,5679,11240
6019,FRESNO,2017,45,5646,5488,11134
6019,FRESNO,2017,46,5823,5696,11519
6019,FRESNO,2017,47,5678,5889,11567
6019,FRESNO,2017,48,5478,5618,11096
6019,FRESNO,2017,49,5525,5437,10962
6019,FRESNO,2017,50,5362,5495,10857
6019,FRESNO,2017,51,5497,5488,10985
6019,FRESNO,2017,52,5505,5594,11099
6019,FRESNO,2017,53,5858,5615,11473
6019,FRESNO,2017,54,5758,5628,11386
6019,FRESNO,2017,55,5632,5488,11120
6019,FRESNO,2017,56,5799,5553,11352
6019,FRESNO,2017,57,5744,5593,11337
6019,FRESNO,2017,58,5468,5216,10684
6019,FRESNO,2017,59,5436,5067,10503
6019,FRESNO,2017,60,5388,5040,10428
6019,FRESNO,2017,61,5028,4912,9940
6019,FRESNO,2017,62,5215,4883,10098
6019,FRESNO,2017,63,5036,4495,9531
6019,FRESNO,2017,64,4729,4296,9025
6019,FRESNO,2017,65,4639,4186,8825
6019,FRESNO,2017,66,4489,3993,8482
6019,FRESNO,2017,67,4299,3948,8247
6019,FRESNO,2017,68,4035,3657,7692
6019,FRESNO,2017,69,3925,3578,7503
6019,FRESNO,2017,70,3828,3322,7150
6019,FRESNO,2017,71,3198,2811,6009
6019,FRESNO,2017,72,3018,2690,5708
6019,FRESNO,2017,73,2977,2494,5471
6019,FRESNO,2017,74,2670,2388,5058
6019,FRESNO,2017,75,2617,2154,4771
6019,FRESNO,2017,76,2409,1873,4282
6019,FRESNO,2017,77,2233,1782,4015
6019,FRESNO,2017,78,2017,1687,3704
6019,FRESNO,2017,79,1854,1522,3376
6019,FRESNO,2017,80,1872,1450,3322
6019,FRESNO,2017,81,1751,1302,3053
6019,FRESNO,2017,82,1644,1142,2786
6019,FRESNO,2017,83,1423,1017,2440
6019,FRESNO,2017,84,1446,946,2392
6019,FRESNO,2017,85,1446,883,2329
6019,FRESNO,2017,86,1465,862,2327
6019,FRESNO,2017,87,1242,832,2074
6019,FRESNO,2017,88,1064,672,1736
6019,FRESNO,2017,89,1002,581,1583
6019,FRESNO,2017,90,938,488,1426
6019,FRESNO,2017,91,759,398,1157
6019,FRESNO,2017,92,594,287,881
6019,FRESNO,2017,93,461,240,701
6019,FRESNO,2017,94,339,163,502
6019,FRESNO,2017,95,354,133,487
6019,FRESNO,2017,96,218,78,296
6019,FRESNO,2017,97,170,56,226
6019,FRESNO,2017,98,71,17,88
6019,FRESNO,2017,99,65,23,88
6019,FRESNO,2017,100,50,24,74
6019,FRESNO,2018,0,7196,7833,15029
6019,FRESNO,2018,1,7083,7867,14950
6019,FRESNO,2018,2,7492,7717,15209
6019,FRESNO,2018,3,7865,7953,15818
6019,FRESNO,2018,4,7907,8264,16171
6019,FRESNO,2018,5,7930,8233,16163
6019,FRESNO,2018,6,7897,8449,16346
6019,FRESNO,2018,7,8153,8405,16558
6019,FRESNO,2018,8,7808,8000,15808
6019,FRESNO,2018,9,7655,7874,15529
6019,FRESNO,2018,10,7913,8378,16291
6019,FRESNO,2018,11,7825,8380,16205
6019,FRESNO,2018,12,7701,8162,15863
6019,FRESNO,2018,13,7495,7890,15385
6019,FRESNO,2018,14,7483,7794,15277
6019,FRESNO,2018,15,7400,7643,15043
6019,FRESNO,2018,16,7242,7488,14730
6019,FRESNO,2018,17,7504,7764,15268
6019,FRESNO,2018,18,8799,9144,17943
6019,FRESNO,2018,19,9237,9688,18925
6019,FRESNO,2018,20,9066,9894,18960
6019,FRESNO,2018,21,8869,9340,18209
6019,FRESNO,2018,22,8531,9061,17592
6019,FRESNO,2018,23,8258,9081,17339
6019,FRESNO,2018,24,8213,8818,17031
6019,FRESNO,2018,25,8108,8666,16774
6019,FRESNO,2018,26,7162,7606,14768
6019,FRESNO,2018,27,6567,6916,13483
6019,FRESNO,2018,28,6031,6383,12414
6019,FRESNO,2018,29,6172,6324,12496
6019,FRESNO,2018,30,6063,6495,12558
6019,FRESNO,2018,31,6273,6775,13048
6019,FRESNO,2018,32,6373,6994,13367
6019,FRESNO,2018,33,6348,6724,13072
6019,FRESNO,2018,34,6541,6905,13446
6019,FRESNO,2018,35,6952,7254,14206
6019,FRESNO,2018,36,6829,7010,13839
6019,FRESNO,2018,37,6757,6887,13644
6019,FRESNO,2018,38,6476,6785,13261
6019,FRESNO,2018,39,6146,6374,12520
6019,FRESNO,2018,40,5963,6045,12008
6019,FRESNO,2018,41,5848,5911,11759
6019,FRESNO,2018,42,5679,5975,11654
6019,FRESNO,2018,43,5728,5952,11680
6019,FRESNO,2018,44,5392,5762,11154
6019,FRESNO,2018,45,5563,5677,11240
6019,FRESNO,2018,46,5641,5432,11073
6019,FRESNO,2018,47,5830,5722,11552
6019,FRESNO,2018,48,5693,5875,11568
6019,FRESNO,2018,49,5482,5604,11086
6019,FRESNO,2018,50,5530,5405,10935
6019,FRESNO,2018,51,5330,5476,10806
6019,FRESNO,2018,52,5472,5406,10878
6019,FRESNO,2018,53,5490,5566,11056
6019,FRESNO,2018,54,5826,5596,11422
6019,FRESNO,2018,55,5734,5542,11276
6019,FRESNO,2018,56,5595,5436,11031
6019,FRESNO,2018,57,5767,5484,11251
6019,FRESNO,2018,58,5727,5557,11284
6019,FRESNO,2018,59,5431,5185,10616
6019,FRESNO,2018,60,5419,4948,10367
6019,FRESNO,2018,61,5357,4992,10349
6019,FRESNO,2018,62,5005,4845,9850
6019,FRESNO,2018,63,5205,4848,10053
6019,FRESNO,2018,64,5013,4412,9425
6019,FRESNO,2018,65,4707,4245,8952
6019,FRESNO,2018,66,4585,4124,8709
6019,FRESNO,2018,67,4437,3904,8341
6019,FRESNO,2018,68,4252,3872,8124
6019,FRESNO,2018,69,3975,3576,7551
6019,FRESNO,2018,70,3891,3516,7407
6019,FRESNO,2018,71,3751,3255,7006
6019,FRESNO,2018,72,3136,2728,5864
6019,FRESNO,2018,73,2937,2627,5564
6019,FRESNO,2018,74,2939,2441,5380
6019,FRESNO,2018,75,2667,2358,5025
6019,FRESNO,2018,76,2584,2038,4622
6019,FRESNO,2018,77,2351,1852,4203
6019,FRESNO,2018,78,2164,1705,3869
6019,FRESNO,2018,79,1949,1650,3599
6019,FRESNO,2018,80,1863,1493,3356
6019,FRESNO,2018,81,1764,1355,3119
6019,FRESNO,2018,82,1681,1202,2883
6019,FRESNO,2018,83,1552,1074,2626
6019,FRESNO,2018,84,1362,980,2342
6019,FRESNO,2018,85,1505,915,2420
6019,FRESNO,2018,86,1314,807,2121
6019,FRESNO,2018,87,1327,800,2127
6019,FRESNO,2018,88,1128,748,1876
6019,FRESNO,2018,89,994,595,1589
6019,FRESNO,2018,90,922,532,1454
6019,FRESNO,2018,91,818,405,1223
6019,FRESNO,2018,92,637,331,968
6019,FRESNO,2018,93,496,225,721
6019,FRESNO,2018,94,400,187,587
6019,FRESNO,2018,95,288,143,431
6019,FRESNO,2018,96,263,92,355
6019,FRESNO,2018,97,168,55,223
6019,FRESNO,2018,98,122,34,156
6019,FRESNO,2018,99,47,12,59
6019,FRESNO,2018,100,79,30,109
6019,FRESNO,2019,0,7058,7957,15015
6019,FRESNO,2019,1,7142,7792,14934
6019,FRESNO,2019,2,7179,7950,15129
6019,FRESNO,2019,3,7571,7854,15425
6019,FRESNO,2019,4,7926,8031,15957
6019,FRESNO,2019,5,7989,8389,16378
6019,FRESNO,2019,6,7952,8249,16201
6019,FRESNO,2019,7,7907,8454,16361
6019,FRESNO,2019,8,8161,8408,16569
6019,FRESNO,2019,9,7824,8032,15856
6019,FRESNO,2019,10,7665,7900,15565
6019,FRESNO,2019,11,7917,8390,16307
6019,FRESNO,2019,12,7856,8385,16241
6019,FRESNO,2019,13,7715,8170,15885
6019,FRESNO,2019,14,7502,7898,15400
6019,FRESNO,2019,15,7512,7817,15329
6019,FRESNO,2019,16,7401,7643,15044
6019,FRESNO,2019,17,7411,7631,15042
6019,FRESNO,2019,18,8798,9137,17935
6019,FRESNO,2019,19,9269,9627,18896
6019,FRESNO,2019,20,9130,9998,19128
6019,FRESNO,2019,21,8817,9491,18308
6019,FRESNO,2019,22,8490,8978,17468
6019,FRESNO,2019,23,8418,8896,17314
6019,FRESNO,2019,24,8038,8854,16892
6019,FRESNO,2019,25,8245,8775,17020
6019,FRESNO,2019,26,7476,8004,15480
6019,FRESNO,2019,27,7098,7581,14679
6019,FRESNO,2019,28,6522,6815,13337
6019,FRESNO,2019,29,6094,6483,12577
6019,FRESNO,2019,30,6107,6228,12335
6019,FRESNO,2019,31,6125,6625,12750
6019,FRESNO,2019,32,6311,6782,13093
6019,FRESNO,2019,33,6398,6937,13335
6019,FRESNO,2019,34,6342,6747,13089
6019,FRESNO,2019,35,6534,6918,13452
6019,FRESNO,2019,36,6911,7185,14096
6019,FRESNO,2019,37,6828,6990,13818
6019,FRESNO,2019,38,6747,6860,13607
6019,FRESNO,2019,39,6493,6829,13322
6019,FRESNO,2019,40,6116,6326,12442
6019,FRESNO,2019,41,5979,6034,12013
6019,FRESNO,2019,42,5854,5941,11795
6019,FRESNO,2019,43,5680,5990,11670
6019,FRESNO,2019,44,5710,5968,11678
6019,FRESNO,2019,45,5397,5761,11158
6019,FRESNO,2019,46,5566,5627,11193
6019,FRESNO,2019,47,5633,5468,11101
6019,FRESNO,2019,48,5846,5716,11562
6019,FRESNO,2019,49,5693,5869,11562
6019,FRESNO,2019,50,5488,5571,11059
6019,FRESNO,2019,51,5517,5374,10891
6019,FRESNO,2019,52,5296,5396,10692
6019,FRESNO,2019,53,5464,5387,10851
6019,FRESNO,2019,54,5455,5560,11015
6019,FRESNO,2019,55,5813,5513,11326
6019,FRESNO,2019,56,5683,5499,11182
6019,FRESNO,2019,57,5562,5347,10909
6019,FRESNO,2019,58,5749,5457,11206
6019,FRESNO,2019,59,5682,5523,11205
6019,FRESNO,2019,60,5411,5074,10485
6019,FRESNO,2019,61,5403,4888,10291
6019,FRESNO,2019,62,5331,4932,10263
6019,FRESNO,2019,63,4988,4807,9795
6019,FRESNO,2019,64,5178,4790,9968
6019,FRESNO,2019,65,4982,4354,9336
6019,FRESNO,2019,66,4646,4195,8841
6019,FRESNO,2019,67,4538,4024,8562
6019,FRESNO,2019,68,4399,3838,8237
6019,FRESNO,2019,69,4189,3784,7973
6019,FRESNO,2019,70,3955,3512,7467
6019,FRESNO,2019,71,3806,3443,7249
6019,FRESNO,2019,72,3690,3186,6876
6019,FRESNO,2019,73,3072,2678,5750
6019,FRESNO,2019,74,2912,2563,5475
6019,FRESNO,2019,75,2943,2400,5343
6019,FRESNO,2019,76,2621,2260,4881
6019,FRESNO,2019,77,2519,1994,4513
6019,FRESNO,2019,78,2294,1767,4061
6019,FRESNO,2019,79,2109,1680,3789
6019,FRESNO,2019,80,1935,1604,3539
6019,FRESNO,2019,81,1774,1403,3177
6019,FRESNO,2019,82,1692,1258,2950
6019,FRESNO,2019,83,1603,1135,2738
6019,FRESNO,2019,84,1492,1023,2515
6019,FRESNO,2019,85,1446,934,2380
6019,FRESNO,2019,86,1374,840,2214
6019,FRESNO,2019,87,1201,744,1945
6019,FRESNO,2019,88,1204,715,1919
6019,FRESNO,2019,89,1035,655,1690
6019,FRESNO,2019,90,921,537,1458
6019,FRESNO,2019,91,797,439,1236
6019,FRESNO,2019,92,665,318,983
6019,FRESNO,2019,93,536,259,795
6019,FRESNO,2019,94,426,167,593
6019,FRESNO,2019,95,338,157,495
6019,FRESNO,2019,96,206,107,313
6019,FRESNO,2019,97,217,61,278
6019,FRESNO,2019,98,125,42,167
6019,FRESNO,2019,99,86,21,107
6019,FRESNO,2019,100,72,31,103
6021,GLENN,2017,0,187,182,369
6021,GLENN,2017,1,175,201,376
6021,GLENN,2017,2,200,195,395
6021,GLENN,2017,3,196,215,411
6021,GLENN,2017,4,189,204,393
6021,GLENN,2017,5,178,200,378
6021,GLENN,2017,6,194,230,424
6021,GLENN,2017,7,203,232,435
6021,GLENN,2017,8,208,214,422
6021,GLENN,2017,9,221,212,433
6021,GLENN,2017,10,196,208,404
6021,GLENN,2017,11,218,253,471
6021,GLENN,2017,12,212,235,447
6021,GLENN,2017,13,210,223,433
6021,GLENN,2017,14,209,201,410
6021,GLENN,2017,15,217,214,431
6021,GLENN,2017,16,220,209,429
6021,GLENN,2017,17,210,211,421
6021,GLENN,2017,18,193,230,423
6021,GLENN,2017,19,233,228,461
6021,GLENN,2017,20,185,220,405
6021,GLENN,2017,21,216,255,471
6021,GLENN,2017,22,225,242,467
6021,GLENN,2017,23,204,218,422
6021,GLENN,2017,24,215,248,463
6021,GLENN,2017,25,206,225,431
6021,GLENN,2017,26,170,214,384
6021,GLENN,2017,27,175,201,376
6021,GLENN,2017,28,182,190,372
6021,GLENN,2017,29,173,195,368
6021,GLENN,2017,30,194,204,398
6021,GLENN,2017,31,179,163,342
6021,GLENN,2017,32,154,197,351
6021,GLENN,2017,33,158,161,319
6021,GLENN,2017,34,176,183,359
6021,GLENN,2017,35,180,187,367
6021,GLENN,2017,36,170,195,365
6021,GLENN,2017,37,163,170,333
6021,GLENN,2017,38,162,188,350
6021,GLENN,2017,39,149,149,298
6021,GLENN,2017,40,174,162,336
6021,GLENN,2017,41,168,179,347
6021,GLENN,2017,42,163,156,319
6021,GLENN,2017,43,172,149,321
6021,GLENN,2017,44,157,180,337
6021,GLENN,2017,45,152,162,314
6021,GLENN,2017,46,159,161,320
6021,GLENN,2017,47,181,168,349
6021,GLENN,2017,48,143,152,295
6021,GLENN,2017,49,176,163,339
6021,GLENN,2017,50,173,177,350
6021,GLENN,2017,51,154,185,339
6021,GLENN,2017,52,165,165,330
6021,GLENN,2017,53,210,168,378
6021,GLENN,2017,54,183,170,353
6021,GLENN,2017,55,190,186,376
6021,GLENN,2017,56,184,196,380
6021,GLENN,2017,57,179,179,358
6021,GLENN,2017,58,170,165,335
6021,GLENN,2017,59,189,180,369
6021,GLENN,2017,60,179,187,366
6021,GLENN,2017,61,210,184,394
6021,GLENN,2017,62,179,188,367
6021,GLENN,2017,63,172,174,346
6021,GLENN,2017,64,151,166,317
6021,GLENN,2017,65,156,163,319
6021,GLENN,2017,66,168,141,309
6021,GLENN,2017,67,137,178,315
6021,GLENN,2017,68,144,113,257
6021,GLENN,2017,69,134,127,261
6021,GLENN,2017,70,128,144,272
6021,GLENN,2017,71,97,111,208
6021,GLENN,2017,72,91,112,203
6021,GLENN,2017,73,116,99,215
6021,GLENN,2017,74,110,80,190
6021,GLENN,2017,75,113,99,212
6021,GLENN,2017,76,86,93,179
6021,GLENN,2017,77,79,83,162
6021,GLENN,2017,78,83,67,150
6021,GLENN,2017,79,81,73,154
6021,GLENN,2017,80,74,70,144
6021,GLENN,2017,81,72,62,134
6021,GLENN,2017,82,53,42,95
6021,GLENN,2017,83,53,38,91
6021,GLENN,2017,84,51,38,89
6021,GLENN,2017,85,59,44,103
6021,GLENN,2017,86,51,39,90
6021,GLENN,2017,87,38,36,74
6021,GLENN,2017,88,35,15,50
6021,GLENN,2017,89,47,25,72
6021,GLENN,2017,90,30,14,44
6021,GLENN,2017,91,16,17,33
6021,GLENN,2017,92,20,16,36
6021,GLENN,2017,93,17,8,25
6021,GLENN,2017,94,16,5,21
6021,GLENN,2017,95,12,7,19
6021,GLENN,2017,96,13,2,15
6021,GLENN,2017,97,6,1,7
6021,GLENN,2017,98,3,2,5
6021,GLENN,2017,99,2,2,4
6021,GLENN,2017,100,2,3,5
6021,GLENN,2018,0,185,201,386
6021,GLENN,2018,1,187,181,368
6021,GLENN,2018,2,175,201,376
6021,GLENN,2018,3,201,196,397
6021,GLENN,2018,4,197,215,412
6021,GLENN,2018,5,190,204,394
6021,GLENN,2018,6,178,201,379
6021,GLENN,2018,7,195,232,427
6021,GLENN,2018,8,201,227,428
6021,GLENN,2018,9,209,214,423
6021,GLENN,2018,10,218,212,430
6021,GLENN,2018,11,199,215,414
6021,GLENN,2018,12,220,250,470
6021,GLENN,2018,13,214,247,461
6021,GLENN,2018,14,212,226,438
6021,GLENN,2018,15,209,202,411
6021,GLENN,2018,16,212,214,426
6021,GLENN,2018,17,217,209,426
6021,GLENN,2018,18,207,205,412
6021,GLENN,2018,19,196,243,439
6021,GLENN,2018,20,223,214,437
6021,GLENN,2018,21,184,223,407
6021,GLENN,2018,22,216,250,466
6021,GLENN,2018,23,223,237,460
6021,GLENN,2018,24,205,224,429
6021,GLENN,2018,25,215,240,455
6021,GLENN,2018,26,207,226,433
6021,GLENN,2018,27,178,230,408
6021,GLENN,2018,28,175,203,378
6021,GLENN,2018,29,186,197,383
6021,GLENN,2018,30,180,198,378
6021,GLENN,2018,31,194,206,400
6021,GLENN,2018,32,179,161,340
6021,GLENN,2018,33,153,192,345
6021,GLENN,2018,34,159,160,319
6021,GLENN,2018,35,179,183,362
6021,GLENN,2018,36,175,185,360
6021,GLENN,2018,37,171,192,363
6021,GLENN,2018,38,161,171,332
6021,GLENN,2018,39,162,191,353
6021,GLENN,2018,40,147,145,292
6021,GLENN,2018,41,176,161,337
6021,GLENN,2018,42,164,175,339
6021,GLENN,2018,43,163,156,319
6021,GLENN,2018,44,170,148,318
6021,GLENN,2018,45,157,179,336
6021,GLENN,2018,46,154,161,315
6021,GLENN,2018,47,157,162,319
6021,GLENN,2018,48,180,168,348
6021,GLENN,2018,49,142,149,291
6021,GLENN,2018,50,177,164,341
6021,GLENN,2018,51,169,177,346
6021,GLENN,2018,52,155,181,336
6021,GLENN,2018,53,162,163,325
6021,GLENN,2018,54,208,164,372
6021,GLENN,2018,55,182,170,352
6021,GLENN,2018,56,188,183,371
6021,GLENN,2018,57,183,195,378
6021,GLENN,2018,58,178,175,353
6021,GLENN,2018,59,170,167,337
6021,GLENN,2018,60,189,178,367
6021,GLENN,2018,61,180,182,362
6021,GLENN,2018,62,202,180,382
6021,GLENN,2018,63,178,185,363
6021,GLENN,2018,64,171,172,343
6021,GLENN,2018,65,148,163,311
6021,GLENN,2018,66,152,159,311
6021,GLENN,2018,67,168,140,308
6021,GLENN,2018,68,131,174,305
6021,GLENN,2018,69,144,108,252
6021,GLENN,2018,70,132,126,258
6021,GLENN,2018,71,123,141,264
6021,GLENN,2018,72,95,114,209
6021,GLENN,2018,73,92,103,195
6021,GLENN,2018,74,112,97,209
6021,GLENN,2018,75,114,78,192
6021,GLENN,2018,76,103,97,200
6021,GLENN,2018,77,83,90,173
6021,GLENN,2018,78,76,76,152
6021,GLENN,2018,79,80,63,143
6021,GLENN,2018,80,81,74,155
6021,GLENN,2018,81,69,64,133
6021,GLENN,2018,82,72,54,126
6021,GLENN,2018,83,50,40,90
6021,GLENN,2018,84,49,36,85
6021,GLENN,2018,85,52,36,88
6021,GLENN,2018,86,51,39,90
6021,GLENN,2018,87,49,34,83
6021,GLENN,2018,88,36,36,72
6021,GLENN,2018,89,35,12,47
6021,GLENN,2018,90,40,22,62
6021,GLENN,2018,91,23,12,35
6021,GLENN,2018,92,16,17,33
6021,GLENN,2018,93,17,15,32
6021,GLENN,2018,94,16,5,21
6021,GLENN,2018,95,13,6,19
6021,GLENN,2018,96,6,6,12
6021,GLENN,2018,97,11,1,12
6021,GLENN,2018,98,7,0,7
6021,GLENN,2018,99,0,1,1
6021,GLENN,2018,100,3,4,7
6021,GLENN,2019,0,177,210,387
6021,GLENN,2019,1,185,201,386
6021,GLENN,2019,2,190,181,371
6021,GLENN,2019,3,177,201,378
6021,GLENN,2019,4,201,196,397
6021,GLENN,2019,5,197,215,412
6021,GLENN,2019,6,190,205,395
6021,GLENN,2019,7,178,202,380
6021,GLENN,2019,8,194,229,423
6021,GLENN,2019,9,201,226,427
6021,GLENN,2019,10,207,214,421
6021,GLENN,2019,11,220,221,441
6021,GLENN,2019,12,203,212,415
6021,GLENN,2019,13,222,256,478
6021,GLENN,2019,14,217,251,468
6021,GLENN,2019,15,213,229,442
6021,GLENN,2019,16,208,199,407
6021,GLENN,2019,17,209,213,422
6021,GLENN,2019,18,216,206,422
6021,GLENN,2019,19,211,213,424
6021,GLENN,2019,20,186,229,415
6021,GLENN,2019,21,222,220,442
6021,GLENN,2019,22,183,218,401
6021,GLENN,2019,23,215,244,459
6021,GLENN,2019,24,223,242,465
6021,GLENN,2019,25,205,217,422
6021,GLENN,2019,26,217,242,459
6021,GLENN,2019,27,212,235,447
6021,GLENN,2019,28,185,228,413
6021,GLENN,2019,29,181,210,391
6021,GLENN,2019,30,193,200,393
6021,GLENN,2019,31,179,201,380
6021,GLENN,2019,32,192,204,396
6021,GLENN,2019,33,179,156,335
6021,GLENN,2019,34,153,191,344
6021,GLENN,2019,35,162,162,324
6021,GLENN,2019,36,175,181,356
6021,GLENN,2019,37,176,183,359
6021,GLENN,2019,38,170,191,361
6021,GLENN,2019,39,160,175,335
6021,GLENN,2019,40,161,187,348
6021,GLENN,2019,41,147,147,294
6021,GLENN,2019,42,173,157,330
6021,GLENN,2019,43,165,176,341
6021,GLENN,2019,44,161,154,315
6021,GLENN,2019,45,170,147,317
6021,GLENN,2019,46,159,180,339
6021,GLENN,2019,47,152,162,314
6021,GLENN,2019,48,157,163,320
6021,GLENN,2019,49,178,166,344
6021,GLENN,2019,50,143,148,291
6021,GLENN,2019,51,175,165,340
6021,GLENN,2019,52,170,172,342
6021,GLENN,2019,53,153,177,330
6021,GLENN,2019,54,161,161,322
6021,GLENN,2019,55,206,164,370
6021,GLENN,2019,56,177,167,344
6021,GLENN,2019,57,188,181,369
6021,GLENN,2019,58,182,193,375
6021,GLENN,2019,59,178,177,355
6021,GLENN,2019,60,167,167,334
6021,GLENN,2019,61,189,170,359
6021,GLENN,2019,62,176,179,355
6021,GLENN,2019,63,203,179,382
6021,GLENN,2019,64,175,184,359
6021,GLENN,2019,65,167,168,335
6021,GLENN,2019,66,146,163,309
6021,GLENN,2019,67,153,156,309
6021,GLENN,2019,68,164,138,302
6021,GLENN,2019,69,128,167,295
6021,GLENN,2019,70,143,106,249
6021,GLENN,2019,71,128,121,249
6021,GLENN,2019,72,115,137,252
6021,GLENN,2019,73,95,108,203
6021,GLENN,2019,74,90,99,189
6021,GLENN,2019,75,112,94,206
6021,GLENN,2019,76,107,78,185
6021,GLENN,2019,77,100,94,194
6021,GLENN,2019,78,79,85,164
6021,GLENN,2019,79,74,73,147
6021,GLENN,2019,80,79,63,142
6021,GLENN,2019,81,76,70,146
6021,GLENN,2019,82,70,58,128
6021,GLENN,2019,83,68,53,121
6021,GLENN,2019,84,46,39,85
6021,GLENN,2019,85,46,33,79
6021,GLENN,2019,86,49,32,81
6021,GLENN,2019,87,45,33,78
6021,GLENN,2019,88,47,29,76
6021,GLENN,2019,89,37,33,70
6021,GLENN,2019,90,31,10,41
6021,GLENN,2019,91,38,20,58
6021,GLENN,2019,92,19,8,27
6021,GLENN,2019,93,13,12,25
6021,GLENN,2019,94,17,13,30
6021,GLENN,2019,95,16,6,22
6021,GLENN,2019,96,5,4,9
6021,GLENN,2019,97,4,4,8
6021,GLENN,2019,98,12,1,13
6021,GLENN,2019,99,2,0,2
6021,GLENN,2019,100,3,4,7
6023,HUMBOLDT,2017,0,715,819,1534
6023,HUMBOLDT,2017,1,744,759,1503
6023,HUMBOLDT,2017,2,658,782,1440
6023,HUMBOLDT,2017,3,728,770,1498
6023,HUMBOLDT,2017,4,801,801,1602
6023,HUMBOLDT,2017,5,756,729,1485
6023,HUMBOLDT,2017,6,791,826,1617
6023,HUMBOLDT,2017,7,770,810,1580
6023,HUMBOLDT,2017,8,752,810,1562
6023,HUMBOLDT,2017,9,820,809,1629
6023,HUMBOLDT,2017,10,821,839,1660
6023,HUMBOLDT,2017,11,775,839,1614
6023,HUMBOLDT,2017,12,726,795,1521
6023,HUMBOLDT,2017,13,762,729,1491
6023,HUMBOLDT,2017,14,725,708,1433
6023,HUMBOLDT,2017,15,844,888,1732
6023,HUMBOLDT,2017,16,770,776,1546
6023,HUMBOLDT,2017,17,739,715,1454
6023,HUMBOLDT,2017,18,1310,1311,2621
6023,HUMBOLDT,2017,19,1195,1220,2415
6023,HUMBOLDT,2017,20,1522,1608,3130
6023,HUMBOLDT,2017,21,1202,1292,2494
6023,HUMBOLDT,2017,22,979,1062,2041
6023,HUMBOLDT,2017,23,1036,1160,2196
6023,HUMBOLDT,2017,24,1119,1083,2202
6023,HUMBOLDT,2017,25,961,974,1935
6023,HUMBOLDT,2017,26,852,886,1738
6023,HUMBOLDT,2017,27,626,644,1270
6023,HUMBOLDT,2017,28,683,747,1430
6023,HUMBOLDT,2017,29,840,900,1740
6023,HUMBOLDT,2017,30,799,887,1686
6023,HUMBOLDT,2017,31,722,812,1534
6023,HUMBOLDT,2017,32,746,875,1621
6023,HUMBOLDT,2017,33,957,984,1941
6023,HUMBOLDT,2017,34,870,975,1845
6023,HUMBOLDT,2017,35,902,1044,1946
6023,HUMBOLDT,2017,36,958,1038,1996
6023,HUMBOLDT,2017,37,943,1094,2037
6023,HUMBOLDT,2017,38,843,981,1824
6023,HUMBOLDT,2017,39,806,888,1694
6023,HUMBOLDT,2017,40,783,845,1628
6023,HUMBOLDT,2017,41,722,838,1560
6023,HUMBOLDT,2017,42,735,987,1722
6023,HUMBOLDT,2017,43,742,842,1584
6023,HUMBOLDT,2017,44,687,772,1459
6023,HUMBOLDT,2017,45,683,793,1476
6023,HUMBOLDT,2017,46,694,812,1506
6023,HUMBOLDT,2017,47,710,791,1501
6023,HUMBOLDT,2017,48,626,724,1350
6023,HUMBOLDT,2017,49,584,710,1294
6023,HUMBOLDT,2017,50,682,661,1343
6023,HUMBOLDT,2017,51,646,642,1288
6023,HUMBOLDT,2017,52,788,768,1556
6023,HUMBOLDT,2017,53,764,751,1515
6023,HUMBOLDT,2017,54,854,857,1711
6023,HUMBOLDT,2017,55,826,822,1648
6023,HUMBOLDT,2017,56,919,855,1774
6023,HUMBOLDT,2017,57,1020,898,1918
6023,HUMBOLDT,2017,58,1054,934,1988
6023,HUMBOLDT,2017,59,1029,956,1985
6023,HUMBOLDT,2017,60,1080,999,2079
6023,HUMBOLDT,2017,61,1046,1006,2052
6023,HUMBOLDT,2017,62,1050,944,1994
6023,HUMBOLDT,2017,63,1075,930,2005
6023,HUMBOLDT,2017,64,1047,902,1949
6023,HUMBOLDT,2017,65,979,913,1892
6023,HUMBOLDT,2017,66,879,840,1719
6023,HUMBOLDT,2017,67,972,875,1847
6023,HUMBOLDT,2017,68,898,833,1731
6023,HUMBOLDT,2017,69,813,831,1644
6023,HUMBOLDT,2017,70,797,757,1554
6023,HUMBOLDT,2017,71,636,623,1259
6023,HUMBOLDT,2017,72,584,560,1144
6023,HUMBOLDT,2017,73,505,468,973
6023,HUMBOLDT,2017,74,558,446,1004
6023,HUMBOLDT,2017,75,451,419,870
6023,HUMBOLDT,2017,76,422,375,797
6023,HUMBOLDT,2017,77,392,349,741
6023,HUMBOLDT,2017,78,362,311,673
6023,HUMBOLDT,2017,79,314,308,622
6023,HUMBOLDT,2017,80,321,286,607
6023,HUMBOLDT,2017,81,309,220,529
6023,HUMBOLDT,2017,82,247,202,449
6023,HUMBOLDT,2017,83,247,198,445
6023,HUMBOLDT,2017,84,246,186,432
6023,HUMBOLDT,2017,85,264,141,405
6023,HUMBOLDT,2017,86,262,113,375
6023,HUMBOLDT,2017,87,229,138,367
6023,HUMBOLDT,2017,88,194,109,303
6023,HUMBOLDT,2017,89,168,125,293
6023,HUMBOLDT,2017,90,152,64,216
6023,HUMBOLDT,2017,91,131,86,217
6023,HUMBOLDT,2017,92,89,71,160
6023,HUMBOLDT,2017,93,87,32,119
6023,HUMBOLDT,2017,94,52,27,79
6023,HUMBOLDT,2017,95,63,19,82
6023,HUMBOLDT,2017,96,43,13,56
6023,HUMBOLDT,2017,97,33,8,41
6023,HUMBOLDT,2017,98,18,6,24
6023,HUMBOLDT,2017,99,11,5,16
6023,HUMBOLDT,2017,100,20,8,28
6023,HUMBOLDT,2018,0,742,783,1525
6023,HUMBOLDT,2018,1,709,812,1521
6023,HUMBOLDT,2018,2,750,760,1510
6023,HUMBOLDT,2018,3,662,794,1456
6023,HUMBOLDT,2018,4,738,784,1522
6023,HUMBOLDT,2018,5,799,807,1606
6023,HUMBOLDT,2018,6,772,739,1511
6023,HUMBOLDT,2018,7,793,834,1627
6023,HUMBOLDT,2018,8,786,814,1600
6023,HUMBOLDT,2018,9,762,817,1579
6023,HUMBOLDT,2018,10,821,816,1637
6023,HUMBOLDT,2018,11,823,839,1662
6023,HUMBOLDT,2018,12,774,839,1613
6023,HUMBOLDT,2018,13,731,792,1523
6023,HUMBOLDT,2018,14,757,728,1485
6023,HUMBOLDT,2018,15,881,849,1730
6023,HUMBOLDT,2018,16,720,780,1500
6023,HUMBOLDT,2018,17,796,792,1588
6023,HUMBOLDT,2018,18,1284,1231,2515
6023,HUMBOLDT,2018,19,1173,1183,2356
6023,HUMBOLDT,2018,20,1572,1647,3219
6023,HUMBOLDT,2018,21,1232,1301,2533
6023,HUMBOLDT,2018,22,993,1108,2101
6023,HUMBOLDT,2018,23,1082,1183,2265
6023,HUMBOLDT,2018,24,1030,1115,2145
6023,HUMBOLDT,2018,25,975,946,1921
6023,HUMBOLDT,2018,26,788,799,1587
6023,HUMBOLDT,2018,27,833,871,1704
6023,HUMBOLDT,2018,28,621,653,1274
6023,HUMBOLDT,2018,29,681,747,1428
6023,HUMBOLDT,2018,30,828,890,1718
6023,HUMBOLDT,2018,31,798,870,1668
6023,HUMBOLDT,2018,32,722,804,1526
6023,HUMBOLDT,2018,33,804,906,1710
6023,HUMBOLDT,2018,34,904,949,1853
6023,HUMBOLDT,2018,35,849,969,1818
6023,HUMBOLDT,2018,36,903,1043,1946
6023,HUMBOLDT,2018,37,953,1010,1963
6023,HUMBOLDT,2018,38,936,1104,2040
6023,HUMBOLDT,2018,39,845,990,1835
6023,HUMBOLDT,2018,40,821,902,1723
6023,HUMBOLDT,2018,41,768,829,1597
6023,HUMBOLDT,2018,42,717,835,1552
6023,HUMBOLDT,2018,43,738,966,1704
6023,HUMBOLDT,2018,44,740,825,1565
6023,HUMBOLDT,2018,45,689,810,1499
6023,HUMBOLDT,2018,46,675,774,1449
6023,HUMBOLDT,2018,47,710,817,1527
6023,HUMBOLDT,2018,48,697,786,1483
6023,HUMBOLDT,2018,49,628,719,1347
6023,HUMBOLDT,2018,50,590,713,1303
6023,HUMBOLDT,2018,51,668,638,1306
6023,HUMBOLDT,2018,52,639,657,1296
6023,HUMBOLDT,2018,53,791,746,1537
6023,HUMBOLDT,2018,54,760,753,1513
6023,HUMBOLDT,2018,55,846,823,1669
6023,HUMBOLDT,2018,56,855,830,1685
6023,HUMBOLDT,2018,57,922,838,1760
6023,HUMBOLDT,2018,58,1031,947,1978
6023,HUMBOLDT,2018,59,1075,945,2020
6023,HUMBOLDT,2018,60,1047,973,2020
6023,HUMBOLDT,2018,61,1064,976,2040
6023,HUMBOLDT,2018,62,1039,987,2026
6023,HUMBOLDT,2018,63,1033,932,1965
6023,HUMBOLDT,2018,64,1073,900,1973
6023,HUMBOLDT,2018,65,1029,895,1924
6023,HUMBOLDT,2018,66,963,889,1852
6023,HUMBOLDT,2018,67,877,826,1703
6023,HUMBOLDT,2018,68,951,857,1808
6023,HUMBOLDT,2018,69,890,813,1703
6023,HUMBOLDT,2018,70,797,815,1612
6023,HUMBOLDT,2018,71,770,728,1498
6023,HUMBOLDT,2018,72,623,613,1236
6023,HUMBOLDT,2018,73,575,546,1121
6023,HUMBOLDT,2018,74,491,453,944
6023,HUMBOLDT,2018,75,551,438,989
6023,HUMBOLDT,2018,76,431,392,823
6023,HUMBOLDT,2018,77,409,367,776
6023,HUMBOLDT,2018,78,386,327,713
6023,HUMBOLDT,2018,79,346,292,638
6023,HUMBOLDT,2018,80,313,297,610
6023,HUMBOLDT,2018,81,303,269,572
6023,HUMBOLDT,2018,82,299,198,497
6023,HUMBOLDT,2018,83,228,187,415
6023,HUMBOLDT,2018,84,224,177,401
6023,HUMBOLDT,2018,85,267,174,441
6023,HUMBOLDT,2018,86,222,130,352
6023,HUMBOLDT,2018,87,239,100,339
6023,HUMBOLDT,2018,88,202,121,323
6023,HUMBOLDT,2018,89,176,88,264
6023,HUMBOLDT,2018,90,152,119,271
6023,HUMBOLDT,2018,91,130,54,184
6023,HUMBOLDT,2018,92,97,73,170
6023,HUMBOLDT,2018,93,77,55,132
6023,HUMBOLDT,2018,94,65,27,92
6023,HUMBOLDT,2018,95,46,20,66
6023,HUMBOLDT,2018,96,43,15,58
6023,HUMBOLDT,2018,97,40,10,50
6023,HUMBOLDT,2018,98,24,5,29
6023,HUMBOLDT,2018,99,12,5,17
6023,HUMBOLDT,2018,100,16,11,27
6023,HUMBOLDT,2019,0,679,721,1400
6023,HUMBOLDT,2019,1,738,779,1517
6023,HUMBOLDT,2019,2,712,814,1526
6023,HUMBOLDT,2019,3,758,774,1532
6023,HUMBOLDT,2019,4,678,798,1476
6023,HUMBOLDT,2019,5,735,787,1522
6023,HUMBOLDT,2019,6,813,816,1629
6023,HUMBOLDT,2019,7,772,746,1518
6023,HUMBOLDT,2019,8,810,836,1646
6023,HUMBOLDT,2019,9,792,822,1614
6023,HUMBOLDT,2019,10,763,828,1591
6023,HUMBOLDT,2019,11,822,816,1638
6023,HUMBOLDT,2019,12,822,839,1661
6023,HUMBOLDT,2019,13,779,837,1616
6023,HUMBOLDT,2019,14,727,791,1518
6023,HUMBOLDT,2019,15,912,869,1781
6023,HUMBOLDT,2019,16,760,736,1496
6023,HUMBOLDT,2019,17,753,791,1544
6023,HUMBOLDT,2019,18,1346,1312,2658
6023,HUMBOLDT,2019,19,1134,1109,2243
6023,HUMBOLDT,2019,20,1547,1615,3162
6023,HUMBOLDT,2019,21,1283,1337,2620
6023,HUMBOLDT,2019,22,1032,1119,2151
6023,HUMBOLDT,2019,23,1098,1227,2325
6023,HUMBOLDT,2019,24,1074,1134,2208
6023,HUMBOLDT,2019,25,880,978,1858
6023,HUMBOLDT,2019,26,800,767,1567
6023,HUMBOLDT,2019,27,772,781,1553
6023,HUMBOLDT,2019,28,828,875,1703
6023,HUMBOLDT,2019,29,618,659,1277
6023,HUMBOLDT,2019,30,668,735,1403
6023,HUMBOLDT,2019,31,824,873,1697
6023,HUMBOLDT,2019,32,796,862,1658
6023,HUMBOLDT,2019,33,780,834,1614
6023,HUMBOLDT,2019,34,748,871,1619
6023,HUMBOLDT,2019,35,885,940,1825
6023,HUMBOLDT,2019,36,850,968,1818
6023,HUMBOLDT,2019,37,896,1015,1911
6023,HUMBOLDT,2019,38,947,1022,1969
6023,HUMBOLDT,2019,39,936,1113,2049
6023,HUMBOLDT,2019,40,861,1005,1866
6023,HUMBOLDT,2019,41,804,886,1690
6023,HUMBOLDT,2019,42,764,825,1589
6023,HUMBOLDT,2019,43,718,817,1535
6023,HUMBOLDT,2019,44,734,948,1682
6023,HUMBOLDT,2019,45,743,862,1605
6023,HUMBOLDT,2019,46,680,789,1469
6023,HUMBOLDT,2019,47,688,782,1470
6023,HUMBOLDT,2019,48,701,818,1519
6023,HUMBOLDT,2019,49,698,777,1475
6023,HUMBOLDT,2019,50,631,722,1353
6023,HUMBOLDT,2019,51,572,693,1265
6023,HUMBOLDT,2019,52,661,651,1312
6023,HUMBOLDT,2019,53,648,637,1285
6023,HUMBOLDT,2019,54,785,741,1526
6023,HUMBOLDT,2019,55,754,725,1479
6023,HUMBOLDT,2019,56,867,830,1697
6023,HUMBOLDT,2019,57,866,815,1681
6023,HUMBOLDT,2019,58,931,866,1797
6023,HUMBOLDT,2019,59,1051,966,2017
6023,HUMBOLDT,2019,60,1100,954,2054
6023,HUMBOLDT,2019,61,1034,946,1980
6023,HUMBOLDT,2019,62,1052,951,2003
6023,HUMBOLDT,2019,63,1023,971,1994
6023,HUMBOLDT,2019,64,1030,905,1935
6023,HUMBOLDT,2019,65,1056,893,1949
6023,HUMBOLDT,2019,66,1019,871,1890
6023,HUMBOLDT,2019,67,951,878,1829
6023,HUMBOLDT,2019,68,855,808,1663
6023,HUMBOLDT,2019,69,940,842,1782
6023,HUMBOLDT,2019,70,871,793,1664
6023,HUMBOLDT,2019,71,785,791,1576
6023,HUMBOLDT,2019,72,751,713,1464
6023,HUMBOLDT,2019,73,608,590,1198
6023,HUMBOLDT,2019,74,562,529,1091
6023,HUMBOLDT,2019,75,486,443,929
6023,HUMBOLDT,2019,76,528,421,949
6023,HUMBOLDT,2019,77,414,383,797
6023,HUMBOLDT,2019,78,404,339,743
6023,HUMBOLDT,2019,79,370,320,690
6023,HUMBOLDT,2019,80,333,287,620
6023,HUMBOLDT,2019,81,299,277,576
6023,HUMBOLDT,2019,82,292,249,541
6023,HUMBOLDT,2019,83,282,182,464
6023,HUMBOLDT,2019,84,210,170,380
6023,HUMBOLDT,2019,85,246,174,420
6023,HUMBOLDT,2019,86,225,148,373
6023,HUMBOLDT,2019,87,221,115,336
6023,HUMBOLDT,2019,88,211,94,305
6023,HUMBOLDT,2019,89,185,109,294
6023,HUMBOLDT,2019,90,161,78,239
6023,HUMBOLDT,2019,91,131,97,228
6023,HUMBOLDT,2019,92,98,49,147
6023,HUMBOLDT,2019,93,89,54,143
6023,HUMBOLDT,2019,94,57,48,105
6023,HUMBOLDT,2019,95,55,21,76
6023,HUMBOLDT,2019,96,35,12,47
6023,HUMBOLDT,2019,97,35,11,46
6023,HUMBOLDT,2019,98,34,7,41
6023,HUMBOLDT,2019,99,17,3,20
6023,HUMBOLDT,2019,100,21,9,30
6025,IMPERIAL,2017,0,1467,1583,3050
6025,IMPERIAL,2017,1,1538,1556,3094
6025,IMPERIAL,2017,2,1650,1665,3315
6025,IMPERIAL,2017,3,1657,1784,3441
6025,IMPERIAL,2017,4,1616,1806,3422
6025,IMPERIAL,2017,5,1727,1752,3479
6025,IMPERIAL,2017,6,1643,1847,3490
6025,IMPERIAL,2017,7,1348,1469,2817
6025,IMPERIAL,2017,8,1373,1503,2876
6025,IMPERIAL,2017,9,1427,1498,2925
6025,IMPERIAL,2017,10,1444,1452,2896
6025,IMPERIAL,2017,11,1400,1409,2809
6025,IMPERIAL,2017,12,1436,1387,2823
6025,IMPERIAL,2017,13,1458,1519,2977
6025,IMPERIAL,2017,14,1391,1419,2810
6025,IMPERIAL,2017,15,1381,1438,2819
6025,IMPERIAL,2017,16,1337,1457,2794
6025,IMPERIAL,2017,17,1414,1541,2955
6025,IMPERIAL,2017,18,1345,1563,2908
6025,IMPERIAL,2017,19,1363,1535,2898
6025,IMPERIAL,2017,20,1381,1753,3134
6025,IMPERIAL,2017,21,1335,1678,3013
6025,IMPERIAL,2017,22,1418,1635,3053
6025,IMPERIAL,2017,23,1456,1593,3049
6025,IMPERIAL,2017,24,1415,1776,3191
6025,IMPERIAL,2017,25,1408,1694,3102
6025,IMPERIAL,2017,26,1299,1721,3020
6025,IMPERIAL,2017,27,1210,1553,2763
6025,IMPERIAL,2017,28,1191,1424,2615
6025,IMPERIAL,2017,29,1089,1463,2552
6025,IMPERIAL,2017,30,1035,1413,2448
6025,IMPERIAL,2017,31,1139,1355,2494
6025,IMPERIAL,2017,32,1019,1268,2287
6025,IMPERIAL,2017,33,1021,1285,2306
6025,IMPERIAL,2017,34,1141,1377,2518
6025,IMPERIAL,2017,35,1073,1276,2349
6025,IMPERIAL,2017,36,1081,1222,2303
6025,IMPERIAL,2017,37,1098,1240,2338
6025,IMPERIAL,2017,38,977,1211,2188
6025,IMPERIAL,2017,39,1009,1177,2186
6025,IMPERIAL,2017,40,978,1169,2147
6025,IMPERIAL,2017,41,1072,1080,2152
6025,IMPERIAL,2017,42,1023,1074,2097
6025,IMPERIAL,2017,43,1046,1097,2143
6025,IMPERIAL,2017,44,1054,1111,2165
6025,IMPERIAL,2017,45,1048,951,1999
6025,IMPERIAL,2017,46,1101,1019,2120
6025,IMPERIAL,2017,47,1083,1149,2232
6025,IMPERIAL,2017,48,1055,1093,2148
6025,IMPERIAL,2017,49,1080,1082,2162
6025,IMPERIAL,2017,50,1087,1016,2103
6025,IMPERIAL,2017,51,1039,1083,2122
6025,IMPERIAL,2017,52,1122,1021,2143
6025,IMPERIAL,2017,53,1097,1041,2138
6025,IMPERIAL,2017,54,1173,1010,2183
6025,IMPERIAL,2017,55,1101,1047,2148
6025,IMPERIAL,2017,56,1080,1028,2108
6025,IMPERIAL,2017,57,1108,1047,2155
6025,IMPERIAL,2017,58,1046,981,2027
6025,IMPERIAL,2017,59,1114,986,2100
6025,IMPERIAL,2017,60,1056,985,2041
6025,IMPERIAL,2017,61,1117,954,2071
6025,IMPERIAL,2017,62,1111,871,1982
6025,IMPERIAL,2017,63,947,841,1788
6025,IMPERIAL,2017,64,959,808,1767
6025,IMPERIAL,2017,65,871,755,1626
6025,IMPERIAL,2017,66,830,705,1535
6025,IMPERIAL,2017,67,789,695,1484
6025,IMPERIAL,2017,68,785,663,1448
6025,IMPERIAL,2017,69,772,620,1392
6025,IMPERIAL,2017,70,678,604,1282
6025,IMPERIAL,2017,71,611,487,1098
6025,IMPERIAL,2017,72,597,424,1021
6025,IMPERIAL,2017,73,554,461,1015
6025,IMPERIAL,2017,74,557,393,950
6025,IMPERIAL,2017,75,562,385,947
6025,IMPERIAL,2017,76,535,372,907
6025,IMPERIAL,2017,77,488,382,870
6025,IMPERIAL,2017,78,458,357,815
6025,IMPERIAL,2017,79,471,300,771
6025,IMPERIAL,2017,80,374,309,683
6025,IMPERIAL,2017,81,384,317,701
6025,IMPERIAL,2017,82,370,246,616
6025,IMPERIAL,2017,83,328,244,572
6025,IMPERIAL,2017,84,312,215,527
6025,IMPERIAL,2017,85,288,217,505
6025,IMPERIAL,2017,86,278,212,490
6025,IMPERIAL,2017,87,249,189,438
6025,IMPERIAL,2017,88,184,135,319
6025,IMPERIAL,2017,89,202,115,317
6025,IMPERIAL,2017,90,194,119,313
6025,IMPERIAL,2017,91,159,97,256
6025,IMPERIAL,2017,92,109,63,172
6025,IMPERIAL,2017,93,114,73,187
6025,IMPERIAL,2017,94,63,33,96
6025,IMPERIAL,2017,95,60,33,93
6025,IMPERIAL,2017,96,38,24,62
6025,IMPERIAL,2017,97,32,10,42
6025,IMPERIAL,2017,98,22,0,22
6025,IMPERIAL,2017,99,8,7,15
6025,IMPERIAL,2017,100,22,19,41
6025,IMPERIAL,2018,0,1500,1647,3147
6025,IMPERIAL,2018,1,1465,1583,3048
6025,IMPERIAL,2018,2,1550,1594,3144
6025,IMPERIAL,2018,3,1664,1698,3362
6025,IMPERIAL,2018,4,1669,1813,3482
6025,IMPERIAL,2018,5,1641,1823,3464
6025,IMPERIAL,2018,6,1744,1764,3508
6025,IMPERIAL,2018,7,1645,1867,3512
6025,IMPERIAL,2018,8,1361,1474,2835
6025,IMPERIAL,2018,9,1384,1516,2900
6025,IMPERIAL,2018,10,1433,1505,2938
6025,IMPERIAL,2018,11,1451,1451,2902
6025,IMPERIAL,2018,12,1412,1411,2823
6025,IMPERIAL,2018,13,1437,1389,2826
6025,IMPERIAL,2018,14,1466,1527,2993
6025,IMPERIAL,2018,15,1397,1441,2838
6025,IMPERIAL,2018,16,1381,1438,2819
6025,IMPERIAL,2018,17,1328,1474,2802
6025,IMPERIAL,2018,18,1414,1529,2943
6025,IMPERIAL,2018,19,1348,1605,2953
6025,IMPERIAL,2018,20,1362,1688,3050
6025,IMPERIAL,2018,21,1379,1740,3119
6025,IMPERIAL,2018,22,1324,1708,3032
6025,IMPERIAL,2018,23,1416,1603,3019
6025,IMPERIAL,2018,24,1451,1649,3100
6025,IMPERIAL,2018,25,1408,1796,3204
6025,IMPERIAL,2018,26,1403,1677,3080
6025,IMPERIAL,2018,27,1293,1748,3041
6025,IMPERIAL,2018,28,1213,1553,2766
6025,IMPERIAL,2018,29,1186,1449,2635
6025,IMPERIAL,2018,30,1090,1455,2545
6025,IMPERIAL,2018,31,1035,1387,2422
6025,IMPERIAL,2018,32,1138,1335,2473
6025,IMPERIAL,2018,33,1018,1291,2309
6025,IMPERIAL,2018,34,1020,1284,2304
6025,IMPERIAL,2018,35,1146,1329,2475
6025,IMPERIAL,2018,36,1064,1257,2321
6025,IMPERIAL,2018,37,1089,1216,2305
6025,IMPERIAL,2018,38,1097,1240,2337
6025,IMPERIAL,2018,39,985,1218,2203
6025,IMPERIAL,2018,40,1004,1151,2155
6025,IMPERIAL,2018,41,983,1120,2103
6025,IMPERIAL,2018,42,1071,1053,2124
6025,IMPERIAL,2018,43,1016,1110,2126
6025,IMPERIAL,2018,44,1045,1073,2118
6025,IMPERIAL,2018,45,1049,1062,2111
6025,IMPERIAL,2018,46,1048,951,1999
6025,IMPERIAL,2018,47,1100,1028,2128
6025,IMPERIAL,2018,48,1075,1168,2243
6025,IMPERIAL,2018,49,1048,1051,2099
6025,IMPERIAL,2018,50,1078,1037,2115
6025,IMPERIAL,2018,51,1081,1032,2113
6025,IMPERIAL,2018,52,1038,1068,2106
6025,IMPERIAL,2018,53,1120,1019,2139
6025,IMPERIAL,2018,54,1097,1051,2148
6025,IMPERIAL,2018,55,1175,965,2140
6025,IMPERIAL,2018,56,1096,1039,2135
6025,IMPERIAL,2018,57,1077,1004,2081
6025,IMPERIAL,2018,58,1105,1054,2159
6025,IMPERIAL,2018,59,1041,963,2004
6025,IMPERIAL,2018,60,1106,951,2057
6025,IMPERIAL,2018,61,1048,975,2023
6025,IMPERIAL,2018,62,1095,950,2045
6025,IMPERIAL,2018,63,1105,857,1962
6025,IMPERIAL,2018,64,943,827,1770
6025,IMPERIAL,2018,65,954,792,1746
6025,IMPERIAL,2018,66,865,741,1606
6025,IMPERIAL,2018,67,820,704,1524
6025,IMPERIAL,2018,68,779,683,1462
6025,IMPERIAL,2018,69,780,647,1427
6025,IMPERIAL,2018,70,765,597,1362
6025,IMPERIAL,2018,71,683,593,1276
6025,IMPERIAL,2018,72,615,480,1095
6025,IMPERIAL,2018,73,591,424,1015
6025,IMPERIAL,2018,74,547,457,1004
6025,IMPERIAL,2018,75,580,385,965
6025,IMPERIAL,2018,76,550,361,911
6025,IMPERIAL,2018,77,525,359,884
6025,IMPERIAL,2018,78,477,371,848
6025,IMPERIAL,2018,79,448,336,784
6025,IMPERIAL,2018,80,465,283,748
6025,IMPERIAL,2018,81,367,293,660
6025,IMPERIAL,2018,82,361,303,664
6025,IMPERIAL,2018,83,360,235,595
6025,IMPERIAL,2018,84,308,222,530
6025,IMPERIAL,2018,85,311,208,519
6025,IMPERIAL,2018,86,263,206,469
6025,IMPERIAL,2018,87,257,193,450
6025,IMPERIAL,2018,88,226,173,399
6025,IMPERIAL,2018,89,168,118,286
6025,IMPERIAL,2018,90,191,106,297
6025,IMPERIAL,2018,91,177,105,282
6025,IMPERIAL,2018,92,149,76,225
6025,IMPERIAL,2018,93,98,56,154
6025,IMPERIAL,2018,94,103,63,166
6025,IMPERIAL,2018,95,56,33,89
6025,IMPERIAL,2018,96,54,22,76
6025,IMPERIAL,2018,97,33,18,51
6025,IMPERIAL,2018,98,26,9,35
6025,IMPERIAL,2018,99,16,1,17
6025,IMPERIAL,2018,100,22,21,43
6025,IMPERIAL,2019,0,1457,1574,3031
6025,IMPERIAL,2019,1,1490,1642,3132
6025,IMPERIAL,2019,2,1476,1627,3103
6025,IMPERIAL,2019,3,1563,1628,3191
6025,IMPERIAL,2019,4,1675,1728,3403
6025,IMPERIAL,2019,5,1695,1828,3523
6025,IMPERIAL,2019,6,1655,1840,3495
6025,IMPERIAL,2019,7,1748,1781,3529
6025,IMPERIAL,2019,8,1654,1869,3523
6025,IMPERIAL,2019,9,1377,1488,2865
6025,IMPERIAL,2019,10,1392,1530,2922
6025,IMPERIAL,2019,11,1439,1508,2947
6025,IMPERIAL,2019,12,1457,1455,2912
6025,IMPERIAL,2019,13,1415,1416,2831
6025,IMPERIAL,2019,14,1444,1399,2843
6025,IMPERIAL,2019,15,1470,1544,3014
6025,IMPERIAL,2019,16,1393,1440,2833
6025,IMPERIAL,2019,17,1380,1457,2837
6025,IMPERIAL,2019,18,1330,1469,2799
6025,IMPERIAL,2019,19,1414,1569,2983
6025,IMPERIAL,2019,20,1347,1763,3110
6025,IMPERIAL,2019,21,1362,1676,3038
6025,IMPERIAL,2019,22,1370,1769,3139
6025,IMPERIAL,2019,23,1324,1675,2999
6025,IMPERIAL,2019,24,1414,1660,3074
6025,IMPERIAL,2019,25,1447,1670,3117
6025,IMPERIAL,2019,26,1404,1776,3180
6025,IMPERIAL,2019,27,1398,1703,3101
6025,IMPERIAL,2019,28,1299,1749,3048
6025,IMPERIAL,2019,29,1207,1579,2786
6025,IMPERIAL,2019,30,1186,1438,2624
6025,IMPERIAL,2019,31,1090,1428,2518
6025,IMPERIAL,2019,32,1034,1367,2401
6025,IMPERIAL,2019,33,1137,1357,2494
6025,IMPERIAL,2019,34,1019,1286,2305
6025,IMPERIAL,2019,35,1025,1238,2263
6025,IMPERIAL,2019,36,1137,1312,2449
6025,IMPERIAL,2019,37,1070,1253,2323
6025,IMPERIAL,2019,38,1086,1215,2301
6025,IMPERIAL,2019,39,1105,1248,2353
6025,IMPERIAL,2019,40,979,1193,2172
6025,IMPERIAL,2019,41,1009,1102,2111
6025,IMPERIAL,2019,42,983,1094,2077
6025,IMPERIAL,2019,43,1064,1091,2155
6025,IMPERIAL,2019,44,1016,1084,2100
6025,IMPERIAL,2019,45,1039,1025,2064
6025,IMPERIAL,2019,46,1046,1061,2107
6025,IMPERIAL,2019,47,1049,955,2004
6025,IMPERIAL,2019,48,1094,1050,2144
6025,IMPERIAL,2019,49,1073,1129,2202
6025,IMPERIAL,2019,50,1047,1006,2053
6025,IMPERIAL,2019,51,1071,1056,2127
6025,IMPERIAL,2019,52,1083,1010,2093
6025,IMPERIAL,2019,53,1038,1066,2104
6025,IMPERIAL,2019,54,1120,1028,2148
6025,IMPERIAL,2019,55,1095,1005,2100
6025,IMPERIAL,2019,56,1167,961,2128
6025,IMPERIAL,2019,57,1092,1014,2106
6025,IMPERIAL,2019,58,1077,1013,2090
6025,IMPERIAL,2019,59,1101,1042,2143
6025,IMPERIAL,2019,60,1039,926,1965
6025,IMPERIAL,2019,61,1097,943,2040
6025,IMPERIAL,2019,62,1040,967,2007
6025,IMPERIAL,2019,63,1096,926,2022
6025,IMPERIAL,2019,64,1100,850,1950
6025,IMPERIAL,2019,65,938,814,1752
6025,IMPERIAL,2019,66,949,775,1724
6025,IMPERIAL,2019,67,855,726,1581
6025,IMPERIAL,2019,68,810,693,1503
6025,IMPERIAL,2019,69,777,669,1446
6025,IMPERIAL,2019,70,771,626,1397
6025,IMPERIAL,2019,71,765,582,1347
6025,IMPERIAL,2019,72,689,576,1265
6025,IMPERIAL,2019,73,609,483,1092
6025,IMPERIAL,2019,74,587,418,1005
6025,IMPERIAL,2019,75,578,452,1030
6025,IMPERIAL,2019,76,564,373,937
6025,IMPERIAL,2019,77,542,345,887
6025,IMPERIAL,2019,78,514,336,850
6025,IMPERIAL,2019,79,459,349,808
6025,IMPERIAL,2019,80,445,325,770
6025,IMPERIAL,2019,81,452,261,713
6025,IMPERIAL,2019,82,349,277,626
6025,IMPERIAL,2019,83,350,298,648
6025,IMPERIAL,2019,84,344,209,553
6025,IMPERIAL,2019,85,302,206,508
6025,IMPERIAL,2019,86,285,184,469
6025,IMPERIAL,2019,87,245,180,425
6025,IMPERIAL,2019,88,242,167,409
6025,IMPERIAL,2019,89,214,155,369
6025,IMPERIAL,2019,90,156,106,262
6025,IMPERIAL,2019,91,167,92,259
6025,IMPERIAL,2019,92,158,88,246
6025,IMPERIAL,2019,93,127,69,196
6025,IMPERIAL,2019,94,84,47,131
6025,IMPERIAL,2019,95,91,51,142
6025,IMPERIAL,2019,96,44,24,68
6025,IMPERIAL,2019,97,46,17,63
6025,IMPERIAL,2019,98,28,17,45
6025,IMPERIAL,2019,99,21,6,27
6025,IMPERIAL,2019,100,31,18,49
6027,INYO,2017,0,103,95,198
6027,INYO,2017,1,93,104,197
6027,INYO,2017,2,113,101,214
6027,INYO,2017,3,139,129,268
6027,INYO,2017,4,110,127,237
6027,INYO,2017,5,126,130,256
6027,INYO,2017,6,100,108,208
6027,INYO,2017,7,111,115,226
6027,INYO,2017,8,90,124,214
6027,INYO,2017,9,103,106,209
6027,INYO,2017,10,107,107,214
6027,INYO,2017,11,101,113,214
6027,INYO,2017,12,104,118,222
6027,INYO,2017,13,107,100,207
6027,INYO,2017,14,85,99,184
6027,INYO,2017,15,92,117,209
6027,INYO,2017,16,86,97,183
6027,INYO,2017,17,92,116,208
6027,INYO,2017,18,100,105,205
6027,INYO,2017,19,90,105,195
6027,INYO,2017,20,112,123,235
6027,INYO,2017,21,111,129,240
6027,INYO,2017,22,113,125,238
6027,INYO,2017,23,111,122,233
6027,INYO,2017,24,113,107,220
6027,INYO,2017,25,122,100,222
6027,INYO,2017,26,75,96,171
6027,INYO,2017,27,92,101,193
6027,INYO,2017,28,70,77,147
6027,INYO,2017,29,73,97,170
6027,INYO,2017,30,67,90,157
6027,INYO,2017,31,85,84,169
6027,INYO,2017,32,85,94,179
6027,INYO,2017,33,104,104,208
6027,INYO,2017,34,112,109,221
6027,INYO,2017,35,106,96,202
6027,INYO,2017,36,103,103,206
6027,INYO,2017,37,97,109,206
6027,INYO,2017,38,88,115,203
6027,INYO,2017,39,105,97,202
6027,INYO,2017,40,94,99,193
6027,INYO,2017,41,71,95,166
6027,INYO,2017,42,90,93,183
6027,INYO,2017,43,83,81,164
6027,INYO,2017,44,83,100,183
6027,INYO,2017,45,97,83,180
6027,INYO,2017,46,98,111,209
6027,INYO,2017,47,89,108,197
6027,INYO,2017,48,100,112,212
6027,INYO,2017,49,112,101,213
6027,INYO,2017,50,91,88,179
6027,INYO,2017,51,104,91,195
6027,INYO,2017,52,127,108,235
6027,INYO,2017,53,112,96,208
6027,INYO,2017,54,146,136,282
6027,INYO,2017,55,146,155,301
6027,INYO,2017,56,146,116,262
6027,INYO,2017,57,173,161,334
6027,INYO,2017,58,161,159,320
6027,INYO,2017,59,153,197,350
6027,INYO,2017,60,150,160,310
6027,INYO,2017,61,163,159,322
6027,INYO,2017,62,154,147,301
6027,INYO,2017,63,179,157,336
6027,INYO,2017,64,145,149,294
6027,INYO,2017,65,124,128,252
6027,INYO,2017,66,152,157,309
6027,INYO,2017,67,117,143,260
6027,INYO,2017,68,141,138,279
6027,INYO,2017,69,119,120,239
6027,INYO,2017,70,120,134,254
6027,INYO,2017,71,113,104,217
6027,INYO,2017,72,89,101,190
6027,INYO,2017,73,91,102,193
6027,INYO,2017,74,111,87,198
6027,INYO,2017,75,87,72,159
6027,INYO,2017,76,67,80,147
6027,INYO,2017,77,65,67,132
6027,INYO,2017,78,78,79,157
6027,INYO,2017,79,72,61,133
6027,INYO,2017,80,60,76,136
6027,INYO,2017,81,60,38,98
6027,INYO,2017,82,56,51,107
6027,INYO,2017,83,57,48,105
6027,INYO,2017,84,51,48,99
6027,INYO,2017,85,53,43,96
6027,INYO,2017,86,53,31,84
6027,INYO,2017,87,40,29,69
6027,INYO,2017,88,39,36,75
6027,INYO,2017,89,40,28,68
6027,INYO,2017,90,35,21,56
6027,INYO,2017,91,31,19,50
6027,INYO,2017,92,20,13,33
6027,INYO,2017,93,11,4,15
6027,INYO,2017,94,16,7,23
6027,INYO,2017,95,10,4,14
6027,INYO,2017,96,7,2,9
6027,INYO,2017,97,6,0,6
6027,INYO,2017,98,4,0,4
6027,INYO,2017,99,4,0,4
6027,INYO,2017,100,3,1,4
6027,INYO,2018,0,89,110,199
6027,INYO,2018,1,102,95,197
6027,INYO,2018,2,93,104,197
6027,INYO,2018,3,113,101,214
6027,INYO,2018,4,138,129,267
6027,INYO,2018,5,110,127,237
6027,INYO,2018,6,128,131,259
6027,INYO,2018,7,100,109,209
6027,INYO,2018,8,113,117,230
6027,INYO,2018,9,90,124,214
6027,INYO,2018,10,103,108,211
6027,INYO,2018,11,107,108,215
6027,INYO,2018,12,104,115,219
6027,INYO,2018,13,104,118,222
6027,INYO,2018,14,110,105,215
6027,INYO,2018,15,86,103,189
6027,INYO,2018,16,88,113,201
6027,INYO,2018,17,82,93,175
6027,INYO,2018,18,89,115,204
6027,INYO,2018,19,95,102,197
6027,INYO,2018,20,87,107,194
6027,INYO,2018,21,110,118,228
6027,INYO,2018,22,112,128,240
6027,INYO,2018,23,112,120,232
6027,INYO,2018,24,111,122,233
6027,INYO,2018,25,110,106,216
6027,INYO,2018,26,123,92,215
6027,INYO,2018,27,73,98,171
6027,INYO,2018,28,93,101,194
6027,INYO,2018,29,68,76,144
6027,INYO,2018,30,76,101,177
6027,INYO,2018,31,64,85,149
6027,INYO,2018,32,85,86,171
6027,INYO,2018,33,85,91,176
6027,INYO,2018,34,104,103,207
6027,INYO,2018,35,111,107,218
6027,INYO,2018,36,107,100,207
6027,INYO,2018,37,103,106,209
6027,INYO,2018,38,97,108,205
6027,INYO,2018,39,88,117,205
6027,INYO,2018,40,106,95,201
6027,INYO,2018,41,93,94,187
6027,INYO,2018,42,71,101,172
6027,INYO,2018,43,87,87,174
6027,INYO,2018,44,82,82,164
6027,INYO,2018,45,81,98,179
6027,INYO,2018,46,98,84,182
6027,INYO,2018,47,98,123,221
6027,INYO,2018,48,91,102,193
6027,INYO,2018,49,98,110,208
6027,INYO,2018,50,113,103,216
6027,INYO,2018,51,95,88,183
6027,INYO,2018,52,103,91,194
6027,INYO,2018,53,132,107,239
6027,INYO,2018,54,114,101,215
6027,INYO,2018,55,148,138,286
6027,INYO,2018,56,147,153,300
6027,INYO,2018,57,149,121,270
6027,INYO,2018,58,178,173,351
6027,INYO,2018,59,164,165,329
6027,INYO,2018,60,154,191,345
6027,INYO,2018,61,150,164,314
6027,INYO,2018,62,164,160,324
6027,INYO,2018,63,155,152,307
6027,INYO,2018,64,178,160,338
6027,INYO,2018,65,144,146,290
6027,INYO,2018,66,124,127,251
6027,INYO,2018,67,149,151,300
6027,INYO,2018,68,115,141,256
6027,INYO,2018,69,139,137,276
6027,INYO,2018,70,117,118,235
6027,INYO,2018,71,120,132,252
6027,INYO,2018,72,109,98,207
6027,INYO,2018,73,90,97,187
6027,INYO,2018,74,90,101,191
6027,INYO,2018,75,108,87,195
6027,INYO,2018,76,84,67,151
6027,INYO,2018,77,67,75,142
6027,INYO,2018,78,63,63,126
6027,INYO,2018,79,72,75,147
6027,INYO,2018,80,72,59,131
6027,INYO,2018,81,54,72,126
6027,INYO,2018,82,60,37,97
6027,INYO,2018,83,52,47,99
6027,INYO,2018,84,55,44,99
6027,INYO,2018,85,45,48,93
6027,INYO,2018,86,50,38,88
6027,INYO,2018,87,46,28,74
6027,INYO,2018,88,32,29,61
6027,INYO,2018,89,48,31,79
6027,INYO,2018,90,30,23,53
6027,INYO,2018,91,27,13,40
6027,INYO,2018,92,25,17,42
6027,INYO,2018,93,23,10,33
6027,INYO,2018,94,5,4,9
6027,INYO,2018,95,14,6,20
6027,INYO,2018,96,6,2,8
6027,INYO,2018,97,5,0,5
6027,INYO,2018,98,7,0,7
6027,INYO,2018,99,2,0,2
6027,INYO,2018,100,7,1,8
6027,INYO,2019,0,101,99,200
6027,INYO,2019,1,88,110,198
6027,INYO,2019,2,102,95,197
6027,INYO,2019,3,93,104,197
6027,INYO,2019,4,113,99,212
6027,INYO,2019,5,138,129,267
6027,INYO,2019,6,112,130,242
6027,INYO,2019,7,128,131,259
6027,INYO,2019,8,100,111,211
6027,INYO,2019,9,113,120,233
6027,INYO,2019,10,90,124,214
6027,INYO,2019,11,103,111,214
6027,INYO,2019,12,109,110,219
6027,INYO,2019,13,104,115,219
6027,INYO,2019,14,106,123,229
6027,INYO,2019,15,112,110,222
6027,INYO,2019,16,84,105,189
6027,INYO,2019,17,87,111,198
6027,INYO,2019,18,77,90,167
6027,INYO,2019,19,84,104,188
6027,INYO,2019,20,92,104,196
6027,INYO,2019,21,85,102,187
6027,INYO,2019,22,111,115,226
6027,INYO,2019,23,110,125,235
6027,INYO,2019,24,110,120,230
6027,INYO,2019,25,108,123,231
6027,INYO,2019,26,110,101,211
6027,INYO,2019,27,121,95,216
6027,INYO,2019,28,74,98,172
6027,INYO,2019,29,91,99,190
6027,INYO,2019,30,70,80,150
6027,INYO,2019,31,73,96,169
6027,INYO,2019,32,64,88,152
6027,INYO,2019,33,85,83,168
6027,INYO,2019,34,86,89,175
6027,INYO,2019,35,104,101,205
6027,INYO,2019,36,112,110,222
6027,INYO,2019,37,106,104,210
6027,INYO,2019,38,105,105,210
6027,INYO,2019,39,97,108,205
6027,INYO,2019,40,89,114,203
6027,INYO,2019,41,104,91,195
6027,INYO,2019,42,93,99,192
6027,INYO,2019,43,71,96,167
6027,INYO,2019,44,86,86,172
6027,INYO,2019,45,82,78,160
6027,INYO,2019,46,82,100,182
6027,INYO,2019,47,98,94,192
6027,INYO,2019,48,100,118,218
6027,INYO,2019,49,89,101,190
6027,INYO,2019,50,100,111,211
6027,INYO,2019,51,118,103,221
6027,INYO,2019,52,91,90,181
6027,INYO,2019,53,108,91,199
6027,INYO,2019,54,133,113,246
6027,INYO,2019,55,117,100,217
6027,INYO,2019,56,148,136,284
6027,INYO,2019,57,147,158,305
6027,INYO,2019,58,157,128,285
6027,INYO,2019,59,182,178,360
6027,INYO,2019,60,167,164,331
6027,INYO,2019,61,155,195,350
6027,INYO,2019,62,150,163,313
6027,INYO,2019,63,166,162,328
6027,INYO,2019,64,157,155,312
6027,INYO,2019,65,176,157,333
6027,INYO,2019,66,143,146,289
6027,INYO,2019,67,121,120,241
6027,INYO,2019,68,147,147,294
6027,INYO,2019,69,116,139,255
6027,INYO,2019,70,138,136,274
6027,INYO,2019,71,115,117,232
6027,INYO,2019,72,117,127,244
6027,INYO,2019,73,110,96,206
6027,INYO,2019,74,91,94,185
6027,INYO,2019,75,88,99,187
6027,INYO,2019,76,104,85,189
6027,INYO,2019,77,79,67,146
6027,INYO,2019,78,68,72,140
6027,INYO,2019,79,59,56,115
6027,INYO,2019,80,69,72,141
6027,INYO,2019,81,63,58,121
6027,INYO,2019,82,56,67,123
6027,INYO,2019,83,56,34,90
6027,INYO,2019,84,51,45,96
6027,INYO,2019,85,53,47,100
6027,INYO,2019,86,39,39,78
6027,INYO,2019,87,45,33,78
6027,INYO,2019,88,36,31,67
6027,INYO,2019,89,39,26,65
6027,INYO,2019,90,40,28,68
6027,INYO,2019,91,25,16,41
6027,INYO,2019,92,21,8,29
6027,INYO,2019,93,26,16,42
6027,INYO,2019,94,18,7,25
6027,INYO,2019,95,3,4,7
6027,INYO,2019,96,8,3,11
6027,INYO,2019,97,6,1,7
6027,INYO,2019,98,3,0,3
6027,INYO,2019,99,3,0,3
6027,INYO,2019,100,5,1,6
6029,KERN,2017,0,6589,7140,13729
6029,KERN,2017,1,6666,6994,13660
6029,KERN,2017,2,6831,7160,13991
6029,KERN,2017,3,6805,7213,14018
6029,KERN,2017,4,7060,7347,14407
6029,KERN,2017,5,6986,7186,14172
6029,KERN,2017,6,7160,7256,14416
6029,KERN,2017,7,7216,7289,14505
6029,KERN,2017,8,7223,7446,14669
6029,KERN,2017,9,7303,7648,14951
6029,KERN,2017,10,7331,7609,14940
6029,KERN,2017,11,7274,7395,14669
6029,KERN,2017,12,6847,7243,14090
6029,KERN,2017,13,6860,7066,13926
6029,KERN,2017,14,6852,6983,13835
6029,KERN,2017,15,6517,6916,13433
6029,KERN,2017,16,6749,7111,13860
6029,KERN,2017,17,6686,7238,13924
6029,KERN,2017,18,7066,7577,14643
6029,KERN,2017,19,7500,7874,15374
6029,KERN,2017,20,7256,8424,15680
6029,KERN,2017,21,7128,8476,15604
6029,KERN,2017,22,7197,8306,15503
6029,KERN,2017,23,7215,8451,15666
6029,KERN,2017,24,7272,8629,15901
6029,KERN,2017,25,6851,8303,15154
6029,KERN,2017,26,6082,7533,13615
6029,KERN,2017,27,5849,7063,12912
6029,KERN,2017,28,5558,6694,12252
6029,KERN,2017,29,5303,6634,11937
6029,KERN,2017,30,5481,6614,12095
6029,KERN,2017,31,5648,6794,12442
6029,KERN,2017,32,5815,6888,12703
6029,KERN,2017,33,5779,6829,12608
6029,KERN,2017,34,5823,6860,12683
6029,KERN,2017,35,5800,6463,12263
6029,KERN,2017,36,5507,6228,11735
6029,KERN,2017,37,5612,6328,11940
6029,KERN,2017,38,5377,5976,11353
6029,KERN,2017,39,5217,5930,11147
6029,KERN,2017,40,5146,5649,10795
6029,KERN,2017,41,5049,5559,10608
6029,KERN,2017,42,5276,5603,10879
6029,KERN,2017,43,4938,5395,10333
6029,KERN,2017,44,4964,5395,10359
6029,KERN,2017,45,4964,5142,10106
6029,KERN,2017,46,5006,5284,10290
6029,KERN,2017,47,5144,5495,10639
6029,KERN,2017,48,4839,5323,10162
6029,KERN,2017,49,4844,5020,9864
6029,KERN,2017,50,4898,4931,9829
6029,KERN,2017,51,4767,5013,9780
6029,KERN,2017,52,5017,5203,10220
6029,KERN,2017,53,5128,5201,10329
6029,KERN,2017,54,5192,5233,10425
6029,KERN,2017,55,5118,5250,10368
6029,KERN,2017,56,5146,5089,10235
6029,KERN,2017,57,5480,5127,10607
6029,KERN,2017,58,5019,5021,10040
6029,KERN,2017,59,4828,4946,9774
6029,KERN,2017,60,4857,4693,9550
6029,KERN,2017,61,4565,4521,9086
6029,KERN,2017,62,4420,4380,8800
6029,KERN,2017,63,4280,4052,8332
6029,KERN,2017,64,4097,3965,8062
6029,KERN,2017,65,3906,3607,7513
6029,KERN,2017,66,3693,3253,6946
6029,KERN,2017,67,3397,3299,6696
6029,KERN,2017,68,3364,2993,6357
6029,KERN,2017,69,3389,3025,6414
6029,KERN,2017,70,3268,2891,6159
6029,KERN,2017,71,2673,2338,5011
6029,KERN,2017,72,2536,2270,4806
6029,KERN,2017,73,2398,2084,4482
6029,KERN,2017,74,2484,2047,4531
6029,KERN,2017,75,2106,1860,3966
6029,KERN,2017,76,1953,1724,3677
6029,KERN,2017,77,1894,1530,3424
6029,KERN,2017,78,1708,1499,3207
6029,KERN,2017,79,1565,1295,2860
6029,KERN,2017,80,1487,1241,2728
6029,KERN,2017,81,1396,1104,2500
6029,KERN,2017,82,1229,997,2226
6029,KERN,2017,83,1129,811,1940
6029,KERN,2017,84,1071,779,1850
6029,KERN,2017,85,1002,717,1719
6029,KERN,2017,86,958,573,1531
6029,KERN,2017,87,837,516,1353
6029,KERN,2017,88,665,476,1141
6029,KERN,2017,89,647,367,1014
6029,KERN,2017,90,626,324,950
6029,KERN,2017,91,510,274,784
6029,KERN,2017,92,321,188,509
6029,KERN,2017,93,298,162,460
6029,KERN,2017,94,235,111,346
6029,KERN,2017,95,208,90,298
6029,KERN,2017,96,135,66,201
6029,KERN,2017,97,71,28,99
6029,KERN,2017,98,48,14,62
6029,KERN,2017,99,16,13,29
6029,KERN,2017,100,35,26,61
6029,KERN,2018,0,6431,7170,13601
6029,KERN,2018,1,6550,7110,13660
6029,KERN,2018,2,6733,7065,13798
6029,KERN,2018,3,6886,7209,14095
6029,KERN,2018,4,6853,7263,14116
6029,KERN,2018,5,7106,7404,14510
6029,KERN,2018,6,6988,7199,14187
6029,KERN,2018,7,7162,7267,14429
6029,KERN,2018,8,7219,7299,14518
6029,KERN,2018,9,7232,7443,14675
6029,KERN,2018,10,7310,7662,14972
6029,KERN,2018,11,7331,7613,14944
6029,KERN,2018,12,7272,7402,14674
6029,KERN,2018,13,6854,7235,14089
6029,KERN,2018,14,6860,7072,13932
6029,KERN,2018,15,6853,7006,13859
6029,KERN,2018,16,6528,6973,13501
6029,KERN,2018,17,6806,7199,14005
6029,KERN,2018,18,7109,7824,14933
6029,KERN,2018,19,7377,8071,15448
6029,KERN,2018,20,7377,8243,15620
6029,KERN,2018,21,7161,8447,15608
6029,KERN,2018,22,7075,8314,15389
6029,KERN,2018,23,7171,8290,15461
6029,KERN,2018,24,7142,8385,15527
6029,KERN,2018,25,7271,8704,15975
6029,KERN,2018,26,6763,8163,14926
6029,KERN,2018,27,6230,7624,13854
6029,KERN,2018,28,5884,7148,13032
6029,KERN,2018,29,5630,6753,12383
6029,KERN,2018,30,5360,6767,12127
6029,KERN,2018,31,5485,6525,12010
6029,KERN,2018,32,5624,6811,12435
6029,KERN,2018,33,5815,6754,12569
6029,KERN,2018,34,5790,6826,12616
6029,KERN,2018,35,5817,6741,12558
6029,KERN,2018,36,5760,6417,12177
6029,KERN,2018,37,5504,6257,11761
6029,KERN,2018,38,5614,6270,11884
6029,KERN,2018,39,5379,5987,11366
6029,KERN,2018,40,5211,5850,11061
6029,KERN,2018,41,5132,5660,10792
6029,KERN,2018,42,5046,5497,10543
6029,KERN,2018,43,5281,5592,10873
6029,KERN,2018,44,4918,5444,10362
6029,KERN,2018,45,4961,5242,10203
6029,KERN,2018,46,4961,5105,10066
6029,KERN,2018,47,5008,5291,10299
6029,KERN,2018,48,5141,5487,10628
6029,KERN,2018,49,4824,5275,10099
6029,KERN,2018,50,4833,4826,9659
6029,KERN,2018,51,4861,4838,9699
6029,KERN,2018,52,4752,5002,9754
6029,KERN,2018,53,4993,5159,10152
6029,KERN,2018,54,5096,5190,10286
6029,KERN,2018,55,5165,5071,10236
6029,KERN,2018,56,5087,5172,10259
6029,KERN,2018,57,5102,5040,10142
6029,KERN,2018,58,5443,5061,10504
6029,KERN,2018,59,4967,4937,9904
6029,KERN,2018,60,4790,4834,9624
6029,KERN,2018,61,4803,4616,9419
6029,KERN,2018,62,4511,4449,8960
6029,KERN,2018,63,4372,4293,8665
6029,KERN,2018,64,4228,3968,8196
6029,KERN,2018,65,4060,3874,7934
6029,KERN,2018,66,3860,3527,7387
6029,KERN,2018,67,3654,3182,6836
6029,KERN,2018,68,3349,3241,6590
6029,KERN,2018,69,3314,2928,6242
6029,KERN,2018,70,3351,2937,6288
6029,KERN,2018,71,3200,2798,5998
6029,KERN,2018,72,2620,2277,4897
6029,KERN,2018,73,2484,2189,4673
6029,KERN,2018,74,2355,2010,4365
6029,KERN,2018,75,2453,2007,4460
6029,KERN,2018,76,2026,1792,3818
6029,KERN,2018,77,1875,1643,3518
6029,KERN,2018,78,1837,1487,3324
6029,KERN,2018,79,1648,1439,3087
6029,KERN,2018,80,1534,1244,2778
6029,KERN,2018,81,1408,1149,2557
6029,KERN,2018,82,1312,1046,2358
6029,KERN,2018,83,1159,918,2077
6029,KERN,2018,84,1064,750,1814
6029,KERN,2018,85,1040,742,1782
6029,KERN,2018,86,908,617,1525
6029,KERN,2018,87,879,520,1399
6029,KERN,2018,88,748,454,1202
6029,KERN,2018,89,581,421,1002
6029,KERN,2018,90,591,330,921
6029,KERN,2018,91,522,260,782
6029,KERN,2018,92,433,226,659
6029,KERN,2018,93,273,154,427
6029,KERN,2018,94,235,134,369
6029,KERN,2018,95,202,89,291
6029,KERN,2018,96,160,61,221
6029,KERN,2018,97,83,45,128
6029,KERN,2018,98,52,22,74
6029,KERN,2018,99,36,10,46
6029,KERN,2018,100,36,25,61
6029,KERN,2019,0,6556,7358,13914
6029,KERN,2019,1,6392,7141,13533
6029,KERN,2019,2,6653,7168,13821
6029,KERN,2019,3,6802,7137,13939
6029,KERN,2019,4,6952,7273,14225
6029,KERN,2019,5,6919,7328,14247
6029,KERN,2019,6,7116,7408,14524
6029,KERN,2019,7,6990,7205,14195
6029,KERN,2019,8,7169,7280,14449
6029,KERN,2019,9,7226,7304,14530
6029,KERN,2019,10,7239,7465,14704
6029,KERN,2019,11,7315,7667,14982
6029,KERN,2019,12,7329,7620,14949
6029,KERN,2019,13,7280,7393,14673
6029,KERN,2019,14,6851,7242,14093
6029,KERN,2019,15,6859,7102,13961
6029,KERN,2019,16,6884,7082,13966
6029,KERN,2019,17,6589,7067,13656
6029,KERN,2019,18,7231,7792,15023
6029,KERN,2019,19,7449,8339,15788
6029,KERN,2019,20,7274,8463,15737
6029,KERN,2019,21,7280,8283,15563
6029,KERN,2019,22,7115,8284,15399
6029,KERN,2019,23,7046,8320,15366
6029,KERN,2019,24,7130,8235,15365
6029,KERN,2019,25,7148,8465,15613
6029,KERN,2019,26,7211,8587,15798
6029,KERN,2019,27,6956,8288,15244
6029,KERN,2019,28,6300,7742,14042
6029,KERN,2019,29,6008,7197,13205
6029,KERN,2019,30,5692,6910,12602
6029,KERN,2019,31,5375,6673,12048
6029,KERN,2019,32,5463,6552,12015
6029,KERN,2019,33,5618,6686,12304
6029,KERN,2019,34,5826,6756,12582
6029,KERN,2019,35,5787,6699,12486
6029,KERN,2019,36,5779,6710,12489
6029,KERN,2019,37,5757,6453,12210
6029,KERN,2019,38,5508,6204,11712
6029,KERN,2019,39,5616,6283,11899
6029,KERN,2019,40,5376,5903,11279
6029,KERN,2019,41,5217,5875,11092
6029,KERN,2019,42,5142,5610,10752
6029,KERN,2019,43,5060,5484,10544
6029,KERN,2019,44,5274,5642,10916
6029,KERN,2019,45,4923,5297,10220
6029,KERN,2019,46,4959,5217,10176
6029,KERN,2019,47,4974,5118,10092
6029,KERN,2019,48,5017,5300,10317
6029,KERN,2019,49,5134,5454,10588
6029,KERN,2019,50,4817,5096,9913
6029,KERN,2019,51,4796,4755,9551
6029,KERN,2019,52,4839,4814,9653
6029,KERN,2019,53,4722,4961,9683
6029,KERN,2019,54,4968,5139,10107
6029,KERN,2019,55,5069,5032,10101
6029,KERN,2019,56,5133,5002,10135
6029,KERN,2019,57,5036,5127,10163
6029,KERN,2019,58,5069,4979,10048
6029,KERN,2019,59,5393,4999,10392
6029,KERN,2019,60,4935,4835,9770
6029,KERN,2019,61,4753,4755,9508
6029,KERN,2019,62,4755,4530,9285
6029,KERN,2019,63,4464,4372,8836
6029,KERN,2019,64,4318,4219,8537
6029,KERN,2019,65,4182,3886,8068
6029,KERN,2019,66,4021,3808,7829
6029,KERN,2019,67,3797,3468,7265
6029,KERN,2019,68,3604,3117,6721
6029,KERN,2019,69,3283,3177,6460
6029,KERN,2019,70,3272,2853,6125
6029,KERN,2019,71,3282,2844,6126
6029,KERN,2019,72,3138,2728,5866
6029,KERN,2019,73,2563,2212,4775
6029,KERN,2019,74,2420,2130,4550
6029,KERN,2019,75,2312,1958,4270
6029,KERN,2019,76,2373,1912,4285
6029,KERN,2019,77,1938,1707,3645
6029,KERN,2019,78,1809,1564,3373
6029,KERN,2019,79,1745,1437,3182
6029,KERN,2019,80,1617,1381,2998
6029,KERN,2019,81,1463,1151,2614
6029,KERN,2019,82,1314,1068,2382
6029,KERN,2019,83,1241,950,2191
6029,KERN,2019,84,1096,851,1947
6029,KERN,2019,85,1035,716,1751
6029,KERN,2019,86,946,638,1584
6029,KERN,2019,87,813,548,1361
6029,KERN,2019,88,807,459,1266
6029,KERN,2019,89,653,400,1053
6029,KERN,2019,90,525,378,903
6029,KERN,2019,91,482,265,747
6029,KERN,2019,92,428,210,638
6029,KERN,2019,93,375,170,545
6029,KERN,2019,94,219,127,346
6029,KERN,2019,95,199,109,308
6029,KERN,2019,96,149,62,211
6029,KERN,2019,97,107,41,148
6029,KERN,2019,98,61,37,98
6029,KERN,2019,99,41,14,55
6029,KERN,2019,100,51,22,73
6031,KINGS,2017,0,1044,1175,2219
6031,KINGS,2017,1,1069,1158,2227
6031,KINGS,2017,2,1154,1232,2386
6031,KINGS,2017,3,1106,1241,2347
6031,KINGS,2017,4,1269,1273,2542
6031,KINGS,2017,5,1191,1261,2452
6031,KINGS,2017,6,1352,1375,2727
6031,KINGS,2017,7,1294,1385,2679
6031,KINGS,2017,8,1354,1408,2762
6031,KINGS,2017,9,1514,1429,2943
6031,KINGS,2017,10,1363,1521,2884
6031,KINGS,2017,11,1352,1352,2704
6031,KINGS,2017,12,1278,1382,2660
6031,KINGS,2017,13,1159,1341,2500
6031,KINGS,2017,14,1252,1210,2462
6031,KINGS,2017,15,1235,1238,2473
6031,KINGS,2017,16,1148,1224,2372
6031,KINGS,2017,17,1216,1220,2436
6031,KINGS,2017,18,1139,1278,2417
6031,KINGS,2017,19,1160,1317,2477
6031,KINGS,2017,20,1142,1482,2624
6031,KINGS,2017,21,1128,1421,2549
6031,KINGS,2017,22,1072,1441,2513
6031,KINGS,2017,23,1060,1450,2510
6031,KINGS,2017,24,1094,1425,2519
6031,KINGS,2017,25,1054,1483,2537
6031,KINGS,2017,26,965,1529,2494
6031,KINGS,2017,27,981,1427,2408
6031,KINGS,2017,28,990,1354,2344
6031,KINGS,2017,29,1014,1423,2437
6031,KINGS,2017,30,1028,1497,2525
6031,KINGS,2017,31,1022,1538,2560
6031,KINGS,2017,32,1014,1433,2447
6031,KINGS,2017,33,1019,1425,2444
6031,KINGS,2017,34,995,1399,2394
6031,KINGS,2017,35,903,1394,2297
6031,KINGS,2017,36,938,1384,2322
6031,KINGS,2017,37,825,1156,1981
6031,KINGS,2017,38,747,1099,1846
6031,KINGS,2017,39,731,1108,1839
6031,KINGS,2017,40,648,1058,1706
6031,KINGS,2017,41,692,1028,1720
6031,KINGS,2017,42,592,963,1555
6031,KINGS,2017,43,610,980,1590
6031,KINGS,2017,44,583,919,1502
6031,KINGS,2017,45,532,924,1456
6031,KINGS,2017,46,596,995,1591
6031,KINGS,2017,47,575,980,1555
6031,KINGS,2017,48,571,944,1515
6031,KINGS,2017,49,557,956,1513
6031,KINGS,2017,50,546,801,1347
6031,KINGS,2017,51,610,854,1464
6031,KINGS,2017,52,591,805,1396
6031,KINGS,2017,53,608,822,1430
6031,KINGS,2017,54,679,819,1498
6031,KINGS,2017,55,627,811,1438
6031,KINGS,2017,56,710,780,1490
6031,KINGS,2017,57,740,858,1598
6031,KINGS,2017,58,634,762,1396
6031,KINGS,2017,59,658,757,1415
6031,KINGS,2017,60,702,682,1384
6031,KINGS,2017,61,619,686,1305
6031,KINGS,2017,62,612,731,1343
6031,KINGS,2017,63,592,638,1230
6031,KINGS,2017,64,637,605,1242
6031,KINGS,2017,65,539,610,1149
6031,KINGS,2017,66,527,491,1018
6031,KINGS,2017,67,562,532,1094
6031,KINGS,2017,68,549,543,1092
6031,KINGS,2017,69,503,475,978
6031,KINGS,2017,70,499,441,940
6031,KINGS,2017,71,406,349,755
6031,KINGS,2017,72,346,346,692
6031,KINGS,2017,73,371,321,692
6031,KINGS,2017,74,326,284,610
6031,KINGS,2017,75,330,281,611
6031,KINGS,2017,76,277,243,520
6031,KINGS,2017,77,328,250,578
6031,KINGS,2017,78,293,214,507
6031,KINGS,2017,79,249,211,460
6031,KINGS,2017,80,248,207,455
6031,KINGS,2017,81,259,186,445
6031,KINGS,2017,82,221,186,407
6031,KINGS,2017,83,205,159,364
6031,KINGS,2017,84,202,133,335
6031,KINGS,2017,85,179,122,301
6031,KINGS,2017,86,181,101,282
6031,KINGS,2017,87,139,86,225
6031,KINGS,2017,88,127,54,181
6031,KINGS,2017,89,120,68,188
6031,KINGS,2017,90,87,54,141
6031,KINGS,2017,91,81,40,121
6031,KINGS,2017,92,56,36,92
6031,KINGS,2017,93,50,30,80
6031,KINGS,2017,94,67,15,82
6031,KINGS,2017,95,25,14,39
6031,KINGS,2017,96,13,5,18
6031,KINGS,2017,97,10,3,13
6031,KINGS,2017,98,9,4,13
6031,KINGS,2017,99,8,2,10
6031,KINGS,2017,100,12,3,15
6031,KINGS,2018,0,1038,1163,2201
6031,KINGS,2018,1,1037,1171,2208
6031,KINGS,2018,2,1094,1173,2267
6031,KINGS,2018,3,1177,1244,2421
6031,KINGS,2018,4,1116,1250,2366
6031,KINGS,2018,5,1283,1279,2562
6031,KINGS,2018,6,1227,1288,2515
6031,KINGS,2018,7,1360,1422,2782
6031,KINGS,2018,8,1326,1409,2735
6031,KINGS,2018,9,1395,1440,2835
6031,KINGS,2018,10,1526,1464,2990
6031,KINGS,2018,11,1374,1527,2901
6031,KINGS,2018,12,1364,1372,2736
6031,KINGS,2018,13,1293,1405,2698
6031,KINGS,2018,14,1185,1352,2537
6031,KINGS,2018,15,1261,1228,2489
6031,KINGS,2018,16,1225,1234,2459
6031,KINGS,2018,17,1152,1266,2418
6031,KINGS,2018,18,1211,1252,2463
6031,KINGS,2018,19,1144,1314,2458
6031,KINGS,2018,20,1152,1536,2688
6031,KINGS,2018,21,1135,1446,2581
6031,KINGS,2018,22,1139,1519,2658
6031,KINGS,2018,23,1069,1391,2460
6031,KINGS,2018,24,1060,1467,2527
6031,KINGS,2018,25,1059,1415,2474
6031,KINGS,2018,26,1064,1523,2587
6031,KINGS,2018,27,969,1512,2481
6031,KINGS,2018,28,999,1436,2435
6031,KINGS,2018,29,991,1352,2343
6031,KINGS,2018,30,1013,1431,2444
6031,KINGS,2018,31,1017,1495,2512
6031,KINGS,2018,32,1010,1487,2497
6031,KINGS,2018,33,1006,1412,2418
6031,KINGS,2018,34,1005,1431,2436
6031,KINGS,2018,35,978,1397,2375
6031,KINGS,2018,36,879,1363,2242
6031,KINGS,2018,37,914,1385,2299
6031,KINGS,2018,38,807,1089,1896
6031,KINGS,2018,39,725,1108,1833
6031,KINGS,2018,40,724,1123,1847
6031,KINGS,2018,41,636,1003,1639
6031,KINGS,2018,42,674,1008,1682
6031,KINGS,2018,43,574,993,1567
6031,KINGS,2018,44,595,961,1556
6031,KINGS,2018,45,569,881,1450
6031,KINGS,2018,46,511,931,1442
6031,KINGS,2018,47,578,964,1542
6031,KINGS,2018,48,561,969,1530
6031,KINGS,2018,49,556,919,1475
6031,KINGS,2018,50,537,821,1358
6031,KINGS,2018,51,546,837,1383
6031,KINGS,2018,52,602,807,1409
6031,KINGS,2018,53,569,764,1333
6031,KINGS,2018,54,598,813,1411
6031,KINGS,2018,55,669,773,1442
6031,KINGS,2018,56,625,776,1401
6031,KINGS,2018,57,691,746,1437
6031,KINGS,2018,58,732,833,1565
6031,KINGS,2018,59,620,750,1370
6031,KINGS,2018,60,653,711,1364
6031,KINGS,2018,61,702,677,1379
6031,KINGS,2018,62,616,683,1299
6031,KINGS,2018,63,603,696,1299
6031,KINGS,2018,64,594,620,1214
6031,KINGS,2018,65,627,588,1215
6031,KINGS,2018,66,530,598,1128
6031,KINGS,2018,67,518,479,997
6031,KINGS,2018,68,550,515,1065
6031,KINGS,2018,69,543,520,1063
6031,KINGS,2018,70,496,456,952
6031,KINGS,2018,71,486,432,918
6031,KINGS,2018,72,404,341,745
6031,KINGS,2018,73,332,319,651
6031,KINGS,2018,74,357,316,673
6031,KINGS,2018,75,325,269,594
6031,KINGS,2018,76,312,273,585
6031,KINGS,2018,77,270,231,501
6031,KINGS,2018,78,322,243,565
6031,KINGS,2018,79,285,207,492
6031,KINGS,2018,80,243,202,445
6031,KINGS,2018,81,241,188,429
6031,KINGS,2018,82,241,186,427
6031,KINGS,2018,83,212,166,378
6031,KINGS,2018,84,189,151,340
6031,KINGS,2018,85,195,120,315
6031,KINGS,2018,86,167,112,279
6031,KINGS,2018,87,160,89,249
6031,KINGS,2018,88,128,77,205
6031,KINGS,2018,89,117,52,169
6031,KINGS,2018,90,105,61,166
6031,KINGS,2018,91,73,42,115
6031,KINGS,2018,92,68,37,105
6031,KINGS,2018,93,52,31,83
6031,KINGS,2018,94,48,19,67
6031,KINGS,2018,95,59,9,68
6031,KINGS,2018,96,18,9,27
6031,KINGS,2018,97,6,4,10
6031,KINGS,2018,98,7,2,9
6031,KINGS,2018,99,7,2,9
6031,KINGS,2018,100,11,4,15
6031,KINGS,2019,0,1066,1145,2211
6031,KINGS,2019,1,1031,1160,2191
6031,KINGS,2019,2,1056,1188,2244
6031,KINGS,2019,3,1118,1187,2305
6031,KINGS,2019,4,1188,1260,2448
6031,KINGS,2019,5,1131,1255,2386
6031,KINGS,2019,6,1315,1302,2617
6031,KINGS,2019,7,1233,1332,2565
6031,KINGS,2019,8,1404,1450,2854
6031,KINGS,2019,9,1381,1440,2821
6031,KINGS,2019,10,1412,1470,2882
6031,KINGS,2019,11,1535,1471,3006
6031,KINGS,2019,12,1386,1541,2927
6031,KINGS,2019,13,1386,1402,2788
6031,KINGS,2019,14,1316,1419,2735
6031,KINGS,2019,15,1196,1373,2569
6031,KINGS,2019,16,1259,1224,2483
6031,KINGS,2019,17,1230,1269,2499
6031,KINGS,2019,18,1149,1296,2445
6031,KINGS,2019,19,1217,1278,2495
6031,KINGS,2019,20,1135,1537,2672
6031,KINGS,2019,21,1145,1500,2645
6031,KINGS,2019,22,1149,1550,2699
6031,KINGS,2019,23,1134,1470,2604
6031,KINGS,2019,24,1071,1408,2479
6031,KINGS,2019,25,1022,1453,2475
6031,KINGS,2019,26,1068,1455,2523
6031,KINGS,2019,27,1068,1505,2573
6031,KINGS,2019,28,983,1525,2508
6031,KINGS,2019,29,1007,1431,2438
6031,KINGS,2019,30,989,1364,2353
6031,KINGS,2019,31,999,1434,2433
6031,KINGS,2019,32,999,1442,2441
6031,KINGS,2019,33,1000,1459,2459
6031,KINGS,2019,34,1003,1416,2419
6031,KINGS,2019,35,997,1440,2437
6031,KINGS,2019,36,960,1371,2331
6031,KINGS,2019,37,862,1358,2220
6031,KINGS,2019,38,900,1325,2225
6031,KINGS,2019,39,786,1092,1878
6031,KINGS,2019,40,715,1125,1840
6031,KINGS,2019,41,714,1074,1788
6031,KINGS,2019,42,625,982,1607
6031,KINGS,2019,43,656,1036,1692
6031,KINGS,2019,44,562,967,1529
6031,KINGS,2019,45,587,921,1508
6031,KINGS,2019,46,550,890,1440
6031,KINGS,2019,47,496,907,1403
6031,KINGS,2019,48,564,955,1519
6031,KINGS,2019,49,552,949,1501
6031,KINGS,2019,50,535,780,1315
6031,KINGS,2019,51,532,856,1388
6031,KINGS,2019,52,542,783,1325
6031,KINGS,2019,53,589,767,1356
6031,KINGS,2019,54,563,760,1323
6031,KINGS,2019,55,583,773,1356
6031,KINGS,2019,56,664,734,1398
6031,KINGS,2019,57,617,744,1361
6031,KINGS,2019,58,680,722,1402
6031,KINGS,2019,59,720,822,1542
6031,KINGS,2019,60,616,705,1321
6031,KINGS,2019,61,653,705,1358
6031,KINGS,2019,62,694,673,1367
6031,KINGS,2019,63,611,655,1266
6031,KINGS,2019,64,600,678,1278
6031,KINGS,2019,65,585,601,1186
6031,KINGS,2019,66,622,577,1199
6031,KINGS,2019,67,519,585,1104
6031,KINGS,2019,68,509,467,976
6031,KINGS,2019,69,542,495,1037
6031,KINGS,2019,70,538,504,1042
6031,KINGS,2019,71,485,449,934
6031,KINGS,2019,72,479,422,901
6031,KINGS,2019,73,392,318,710
6031,KINGS,2019,74,323,315,638
6031,KINGS,2019,75,351,305,656
6031,KINGS,2019,76,310,257,567
6031,KINGS,2019,77,303,260,563
6031,KINGS,2019,78,264,219,483
6031,KINGS,2019,79,301,233,534
6031,KINGS,2019,80,278,198,476
6031,KINGS,2019,81,230,187,417
6031,KINGS,2019,82,232,177,409
6031,KINGS,2019,83,236,163,399
6031,KINGS,2019,84,199,161,360
6031,KINGS,2019,85,185,141,326
6031,KINGS,2019,86,185,105,290
6031,KINGS,2019,87,138,96,234
6031,KINGS,2019,88,148,74,222
6031,KINGS,2019,89,118,71,189
6031,KINGS,2019,90,101,47,148
6031,KINGS,2019,91,93,43,136
6031,KINGS,2019,92,62,39,101
6031,KINGS,2019,93,59,34,93
6031,KINGS,2019,94,48,24,72
6031,KINGS,2019,95,47,13,60
6031,KINGS,2019,96,43,8,51
6031,KINGS,2019,97,12,7,19
6031,KINGS,2019,98,6,2,8
6031,KINGS,2019,99,5,1,6
6031,KINGS,2019,100,12,5,17
6033,LAKE,2017,0,343,379,722
6033,LAKE,2017,1,366,353,719
6033,LAKE,2017,2,352,361,713
6033,LAKE,2017,3,414,378,792
6033,LAKE,2017,4,414,363,777
6033,LAKE,2017,5,365,415,780
6033,LAKE,2017,6,351,423,774
6033,LAKE,2017,7,359,387,746
6033,LAKE,2017,8,367,402,769
6033,LAKE,2017,9,361,421,782
6033,LAKE,2017,10,368,403,771
6033,LAKE,2017,11,372,410,782
6033,LAKE,2017,12,365,395,760
6033,LAKE,2017,13,359,385,744
6033,LAKE,2017,14,370,360,730
6033,LAKE,2017,15,326,401,727
6033,LAKE,2017,16,376,363,739
6033,LAKE,2017,17,370,383,753
6033,LAKE,2017,18,366,359,725
6033,LAKE,2017,19,339,398,737
6033,LAKE,2017,20,351,433,784
6033,LAKE,2017,21,366,455,821
6033,LAKE,2017,22,396,408,804
6033,LAKE,2017,23,406,409,815
6033,LAKE,2017,24,407,424,831
6033,LAKE,2017,25,390,464,854
6033,LAKE,2017,26,345,424,769
6033,LAKE,2017,27,321,396,717
6033,LAKE,2017,28,349,368,717
6033,LAKE,2017,29,368,357,725
6033,LAKE,2017,30,328,342,670
6033,LAKE,2017,31,371,412,783
6033,LAKE,2017,32,340,362,702
6033,LAKE,2017,33,393,378,771
6033,LAKE,2017,34,304,367,671
6033,LAKE,2017,35,312,374,686
6033,LAKE,2017,36,334,346,680
6033,LAKE,2017,37,289,342,631
6033,LAKE,2017,38,315,325,640
6033,LAKE,2017,39,288,342,630
6033,LAKE,2017,40,300,329,629
6033,LAKE,2017,41,300,304,604
6033,LAKE,2017,42,300,353,653
6033,LAKE,2017,43,277,311,588
6033,LAKE,2017,44,312,296,608
6033,LAKE,2017,45,366,313,679
6033,LAKE,2017,46,407,341,748
6033,LAKE,2017,47,417,378,795
6033,LAKE,2017,48,379,396,775
6033,LAKE,2017,49,354,323,677
6033,LAKE,2017,50,398,373,771
6033,LAKE,2017,51,367,423,790
6033,LAKE,2017,52,464,426,890
6033,LAKE,2017,53,456,402,858
6033,LAKE,2017,54,472,412,884
6033,LAKE,2017,55,470,447,917
6033,LAKE,2017,56,478,436,914
6033,LAKE,2017,57,513,515,1028
6033,LAKE,2017,58,520,482,1002
6033,LAKE,2017,59,522,534,1056
6033,LAKE,2017,60,563,485,1048
6033,LAKE,2017,61,522,487,1009
6033,LAKE,2017,62,550,483,1033
6033,LAKE,2017,63,534,461,995
6033,LAKE,2017,64,542,495,1037
6033,LAKE,2017,65,564,488,1052
6033,LAKE,2017,66,459,439,898
6033,LAKE,2017,67,474,497,971
6033,LAKE,2017,68,498,474,972
6033,LAKE,2017,69,472,483,955
6033,LAKE,2017,70,509,484,993
6033,LAKE,2017,71,364,374,738
6033,LAKE,2017,72,381,348,729
6033,LAKE,2017,73,337,314,651
6033,LAKE,2017,74,333,343,676
6033,LAKE,2017,75,311,290,601
6033,LAKE,2017,76,286,240,526
6033,LAKE,2017,77,245,249,494
6033,LAKE,2017,78,228,223,451
6033,LAKE,2017,79,236,219,455
6033,LAKE,2017,80,208,183,391
6033,LAKE,2017,81,205,171,376
6033,LAKE,2017,82,174,138,312
6033,LAKE,2017,83,165,137,302
6033,LAKE,2017,84,136,121,257
6033,LAKE,2017,85,186,113,299
6033,LAKE,2017,86,133,98,231
6033,LAKE,2017,87,113,66,179
6033,LAKE,2017,88,103,76,179
6033,LAKE,2017,89,93,54,147
6033,LAKE,2017,90,89,53,142
6033,LAKE,2017,91,88,41,129
6033,LAKE,2017,92,48,47,95
6033,LAKE,2017,93,31,18,49
6033,LAKE,2017,94,38,16,54
6033,LAKE,2017,95,14,12,26
6033,LAKE,2017,96,29,11,40
6033,LAKE,2017,97,12,10,22
6033,LAKE,2017,98,14,5,19
6033,LAKE,2017,99,11,1,12
6033,LAKE,2017,100,5,2,7
6033,LAKE,2018,0,361,368,729
6033,LAKE,2018,1,341,374,715
6033,LAKE,2018,2,368,357,725
6033,LAKE,2018,3,356,371,727
6033,LAKE,2018,4,419,377,796
6033,LAKE,2018,5,414,366,780
6033,LAKE,2018,6,365,426,791
6033,LAKE,2018,7,354,438,792
6033,LAKE,2018,8,367,382,749
6033,LAKE,2018,9,365,409,774
6033,LAKE,2018,10,365,421,786
6033,LAKE,2018,11,372,404,776
6033,LAKE,2018,12,364,409,773
6033,LAKE,2018,13,364,392,756
6033,LAKE,2018,14,365,390,755
6033,LAKE,2018,15,364,355,719
6033,LAKE,2018,16,331,404,735
6033,LAKE,2018,17,380,365,745
6033,LAKE,2018,18,368,380,748
6033,LAKE,2018,19,362,366,728
6033,LAKE,2018,20,339,399,738
6033,LAKE,2018,21,346,427,773
6033,LAKE,2018,22,368,452,820
6033,LAKE,2018,23,398,409,807
6033,LAKE,2018,24,400,403,803
6033,LAKE,2018,25,410,425,835
6033,LAKE,2018,26,390,474,864
6033,LAKE,2018,27,351,427,778
6033,LAKE,2018,28,329,417,746
6033,LAKE,2018,29,362,358,720
6033,LAKE,2018,30,375,364,739
6033,LAKE,2018,31,325,337,662
6033,LAKE,2018,32,366,409,775
6033,LAKE,2018,33,340,363,703
6033,LAKE,2018,34,394,369,763
6033,LAKE,2018,35,298,360,658
6033,LAKE,2018,36,310,388,698
6033,LAKE,2018,37,334,338,672
6033,LAKE,2018,38,296,337,633
6033,LAKE,2018,39,315,330,645
6033,LAKE,2018,40,287,332,619
6033,LAKE,2018,41,298,329,627
6033,LAKE,2018,42,303,314,617
6033,LAKE,2018,43,308,354,662
6033,LAKE,2018,44,278,310,588
6033,LAKE,2018,45,317,287,604
6033,LAKE,2018,46,367,319,686
6033,LAKE,2018,47,406,346,752
6033,LAKE,2018,48,413,375,788
6033,LAKE,2018,49,375,393,768
6033,LAKE,2018,50,360,320,680
6033,LAKE,2018,51,394,382,776
6033,LAKE,2018,52,365,406,771
6033,LAKE,2018,53,464,430,894
6033,LAKE,2018,54,456,388,844
6033,LAKE,2018,55,468,411,879
6033,LAKE,2018,56,464,439,903
6033,LAKE,2018,57,469,423,892
6033,LAKE,2018,58,509,516,1025
6033,LAKE,2018,59,516,479,995
6033,LAKE,2018,60,518,531,1049
6033,LAKE,2018,61,556,475,1031
6033,LAKE,2018,62,521,483,1004
6033,LAKE,2018,63,544,470,1014
6033,LAKE,2018,64,529,462,991
6033,LAKE,2018,65,538,485,1023
6033,LAKE,2018,66,550,481,1031
6033,LAKE,2018,67,451,429,880
6033,LAKE,2018,68,468,481,949
6033,LAKE,2018,69,483,466,949
6033,LAKE,2018,70,470,473,943
6033,LAKE,2018,71,496,467,963
6033,LAKE,2018,72,357,363,720
6033,LAKE,2018,73,375,341,716
6033,LAKE,2018,74,327,303,630
6033,LAKE,2018,75,328,335,663
6033,LAKE,2018,76,307,272,579
6033,LAKE,2018,77,275,224,499
6033,LAKE,2018,78,233,233,466
6033,LAKE,2018,79,222,212,434
6033,LAKE,2018,80,242,211,453
6033,LAKE,2018,81,192,166,358
6033,LAKE,2018,82,184,160,344
6033,LAKE,2018,83,168,129,297
6033,LAKE,2018,84,157,119,276
6033,LAKE,2018,85,145,109,254
6033,LAKE,2018,86,159,104,263
6033,LAKE,2018,87,122,92,214
6033,LAKE,2018,88,106,57,163
6033,LAKE,2018,89,89,70,159
6033,LAKE,2018,90,90,45,135
6033,LAKE,2018,91,78,42,120
6033,LAKE,2018,92,70,32,102
6033,LAKE,2018,93,36,36,72
6033,LAKE,2018,94,24,16,40
6033,LAKE,2018,95,34,11,45
6033,LAKE,2018,96,10,8,18
6033,LAKE,2018,97,24,7,31
6033,LAKE,2018,98,7,6,13
6033,LAKE,2018,99,11,5,16
6033,LAKE,2018,100,11,1,12
6033,LAKE,2019,0,350,396,746
6033,LAKE,2019,1,359,365,724
6033,LAKE,2019,2,343,379,722
6033,LAKE,2019,3,373,367,740
6033,LAKE,2019,4,355,374,729
6033,LAKE,2019,5,419,382,801
6033,LAKE,2019,6,414,375,789
6033,LAKE,2019,7,369,440,809
6033,LAKE,2019,8,361,432,793
6033,LAKE,2019,9,367,390,757
6033,LAKE,2019,10,372,409,781
6033,LAKE,2019,11,370,422,792
6033,LAKE,2019,12,365,401,766
6033,LAKE,2019,13,363,407,770
6033,LAKE,2019,14,370,396,766
6033,LAKE,2019,15,359,386,745
6033,LAKE,2019,16,366,359,725
6033,LAKE,2019,17,335,407,742
6033,LAKE,2019,18,378,364,742
6033,LAKE,2019,19,368,387,755
6033,LAKE,2019,20,362,365,727
6033,LAKE,2019,21,333,393,726
6033,LAKE,2019,22,347,425,772
6033,LAKE,2019,23,369,453,822
6033,LAKE,2019,24,394,404,798
6033,LAKE,2019,25,401,406,807
6033,LAKE,2019,26,412,436,848
6033,LAKE,2019,27,394,482,876
6033,LAKE,2019,28,353,447,800
6033,LAKE,2019,29,348,412,760
6033,LAKE,2019,30,367,363,730
6033,LAKE,2019,31,370,355,725
6033,LAKE,2019,32,323,335,658
6033,LAKE,2019,33,366,412,778
6033,LAKE,2019,34,344,352,696
6033,LAKE,2019,35,387,365,752
6033,LAKE,2019,36,298,372,670
6033,LAKE,2019,37,312,381,693
6033,LAKE,2019,38,340,337,677
6033,LAKE,2019,39,293,341,634
6033,LAKE,2019,40,315,321,636
6033,LAKE,2019,41,287,333,620
6033,LAKE,2019,42,303,339,642
6033,LAKE,2019,43,310,314,624
6033,LAKE,2019,44,307,354,661
6033,LAKE,2019,45,284,301,585
6033,LAKE,2019,46,317,292,609
6033,LAKE,2019,47,366,322,688
6033,LAKE,2019,48,405,343,748
6033,LAKE,2019,49,407,370,777
6033,LAKE,2019,50,381,390,771
6033,LAKE,2019,51,354,330,684
6033,LAKE,2019,52,397,367,764
6033,LAKE,2019,53,365,415,780
6033,LAKE,2019,54,460,415,875
6033,LAKE,2019,55,449,386,835
6033,LAKE,2019,56,469,409,878
6033,LAKE,2019,57,461,424,885
6033,LAKE,2019,58,467,420,887
6033,LAKE,2019,59,506,512,1018
6033,LAKE,2019,60,509,470,979
6033,LAKE,2019,61,514,519,1033
6033,LAKE,2019,62,556,468,1024
6033,LAKE,2019,63,518,475,993
6033,LAKE,2019,64,536,467,1003
6033,LAKE,2019,65,517,450,967
6033,LAKE,2019,66,530,476,1006
6033,LAKE,2019,67,542,476,1018
6033,LAKE,2019,68,441,418,859
6033,LAKE,2019,69,455,467,922
6033,LAKE,2019,70,481,451,932
6033,LAKE,2019,71,462,465,927
6033,LAKE,2019,72,484,454,938
6033,LAKE,2019,73,353,348,701
6033,LAKE,2019,74,365,332,697
6033,LAKE,2019,75,323,298,621
6033,LAKE,2019,76,316,318,634
6033,LAKE,2019,77,289,258,547
6033,LAKE,2019,78,267,221,488
6033,LAKE,2019,79,225,227,452
6033,LAKE,2019,80,220,211,431
6033,LAKE,2019,81,233,196,429
6033,LAKE,2019,82,173,151,324
6033,LAKE,2019,83,174,150,324
6033,LAKE,2019,84,163,115,278
6033,LAKE,2019,85,162,113,275
6033,LAKE,2019,86,125,103,228
6033,LAKE,2019,87,148,89,237
6033,LAKE,2019,88,110,82,192
6033,LAKE,2019,89,97,53,150
6033,LAKE,2019,90,85,59,144
6033,LAKE,2019,91,73,39,112
6033,LAKE,2019,92,58,32,90
6033,LAKE,2019,93,61,22,83
6033,LAKE,2019,94,33,30,63
6033,LAKE,2019,95,18,12,30
6033,LAKE,2019,96,26,9,35
6033,LAKE,2019,97,9,4,13
6033,LAKE,2019,98,17,3,20
6033,LAKE,2019,99,5,4,9
6033,LAKE,2019,100,17,3,20
6035,LASSEN,2017,0,136,160,296
6035,LASSEN,2017,1,141,149,290
6035,LASSEN,2017,2,148,154,302
6035,LASSEN,2017,3,165,157,322
6035,LASSEN,2017,4,129,157,286
6035,LASSEN,2017,5,150,149,299
6035,LASSEN,2017,6,165,151,316
6035,LASSEN,2017,7,161,165,326
6035,LASSEN,2017,8,171,157,328
6035,LASSEN,2017,9,140,152,292
6035,LASSEN,2017,10,128,159,287
6035,LASSEN,2017,11,121,159,280
6035,LASSEN,2017,12,107,127,234
6035,LASSEN,2017,13,120,144,264
6035,LASSEN,2017,14,131,136,267
6035,LASSEN,2017,15,132,142,274
6035,LASSEN,2017,16,131,172,303
6035,LASSEN,2017,17,156,167,323
6035,LASSEN,2017,18,150,214,364
6035,LASSEN,2017,19,158,241,399
6035,LASSEN,2017,20,177,356,533
6035,LASSEN,2017,21,135,360,495
6035,LASSEN,2017,22,140,353,493
6035,LASSEN,2017,23,123,368,491
6035,LASSEN,2017,24,133,403,536
6035,LASSEN,2017,25,126,422,548
6035,LASSEN,2017,26,109,447,556
6035,LASSEN,2017,27,92,400,492
6035,LASSEN,2017,28,86,370,456
6035,LASSEN,2017,29,84,408,492
6035,LASSEN,2017,30,85,345,430
6035,LASSEN,2017,31,71,393,464
6035,LASSEN,2017,32,123,314,437
6035,LASSEN,2017,33,86,328,414
6035,LASSEN,2017,34,91,296,387
6035,LASSEN,2017,35,83,293,376
6035,LASSEN,2017,36,97,313,410
6035,LASSEN,2017,37,80,294,374
6035,LASSEN,2017,38,99,296,395
6035,LASSEN,2017,39,83,292,375
6035,LASSEN,2017,40,94,269,363
6035,LASSEN,2017,41,107,305,412
6035,LASSEN,2017,42,104,287,391
6035,LASSEN,2017,43,94,251,345
6035,LASSEN,2017,44,119,280,399
6035,LASSEN,2017,45,114,284,398
6035,LASSEN,2017,46,158,263,421
6035,LASSEN,2017,47,142,324,466
6035,LASSEN,2017,48,142,288,430
6035,LASSEN,2017,49,149,279,428
6035,LASSEN,2017,50,134,241,375
6035,LASSEN,2017,51,164,217,381
6035,LASSEN,2017,52,188,287,475
6035,LASSEN,2017,53,171,279,450
6035,LASSEN,2017,54,207,271,478
6035,LASSEN,2017,55,170,252,422
6035,LASSEN,2017,56,194,205,399
6035,LASSEN,2017,57,202,238,440
6035,LASSEN,2017,58,216,241,457
6035,LASSEN,2017,59,197,261,458
6035,LASSEN,2017,60,178,210,388
6035,LASSEN,2017,61,220,176,396
6035,LASSEN,2017,62,223,202,425
6035,LASSEN,2017,63,204,213,417
6035,LASSEN,2017,64,212,238,450
6035,LASSEN,2017,65,192,203,395
6035,LASSEN,2017,66,184,196,380
6035,LASSEN,2017,67,165,196,361
6035,LASSEN,2017,68,168,184,352
6035,LASSEN,2017,69,162,179,341
6035,LASSEN,2017,70,177,161,338
6035,LASSEN,2017,71,137,126,263
6035,LASSEN,2017,72,115,119,234
6035,LASSEN,2017,73,114,121,235
6035,LASSEN,2017,74,116,115,231
6035,LASSEN,2017,75,114,95,209
6035,LASSEN,2017,76,89,81,170
6035,LASSEN,2017,77,76,77,153
6035,LASSEN,2017,78,92,70,162
6035,LASSEN,2017,79,61,66,127
6035,LASSEN,2017,80,59,47,106
6035,LASSEN,2017,81,65,62,127
6035,LASSEN,2017,82,45,48,93
6035,LASSEN,2017,83,39,39,78
6035,LASSEN,2017,84,42,48,90
6035,LASSEN,2017,85,49,31,80
6035,LASSEN,2017,86,35,31,66
6035,LASSEN,2017,87,44,35,79
6035,LASSEN,2017,88,32,14,46
6035,LASSEN,2017,89,25,27,52
6035,LASSEN,2017,90,28,20,48
6035,LASSEN,2017,91,15,14,29
6035,LASSEN,2017,92,24,20,44
6035,LASSEN,2017,93,25,4,29
6035,LASSEN,2017,94,4,7,11
6035,LASSEN,2017,95,10,10,20
6035,LASSEN,2017,96,8,2,10
6035,LASSEN,2017,97,4,3,7
6035,LASSEN,2017,98,6,0,6
6035,LASSEN,2017,99,2,0,2
6035,LASSEN,2017,100,5,3,8
6035,LASSEN,2018,0,140,155,295
6035,LASSEN,2018,1,136,160,296
6035,LASSEN,2018,2,142,148,290
6035,LASSEN,2018,3,148,154,302
6035,LASSEN,2018,4,163,156,319
6035,LASSEN,2018,5,129,156,285
6035,LASSEN,2018,6,150,149,299
6035,LASSEN,2018,7,163,153,316
6035,LASSEN,2018,8,161,162,323
6035,LASSEN,2018,9,170,156,326
6035,LASSEN,2018,10,141,153,294
6035,LASSEN,2018,11,128,158,286
6035,LASSEN,2018,12,120,159,279
6035,LASSEN,2018,13,105,126,231
6035,LASSEN,2018,14,122,144,266
6035,LASSEN,2018,15,128,138,266
6035,LASSEN,2018,16,132,145,277
6035,LASSEN,2018,17,131,177,308
6035,LASSEN,2018,18,163,214,377
6035,LASSEN,2018,19,150,225,375
6035,LASSEN,2018,20,150,360,510
6035,LASSEN,2018,21,174,395,569
6035,LASSEN,2018,22,133,357,490
6035,LASSEN,2018,23,141,358,499
6035,LASSEN,2018,24,118,387,505
6035,LASSEN,2018,25,134,433,567
6035,LASSEN,2018,26,126,415,541
6035,LASSEN,2018,27,108,474,582
6035,LASSEN,2018,28,90,368,458
6035,LASSEN,2018,29,86,421,507
6035,LASSEN,2018,30,82,350,432
6035,LASSEN,2018,31,79,358,437
6035,LASSEN,2018,32,72,339,411
6035,LASSEN,2018,33,122,312,434
6035,LASSEN,2018,34,85,313,398
6035,LASSEN,2018,35,91,273,364
6035,LASSEN,2018,36,82,313,395
6035,LASSEN,2018,37,98,289,387
6035,LASSEN,2018,38,80,295,375
6035,LASSEN,2018,39,98,297,395
6035,LASSEN,2018,40,85,263,348
6035,LASSEN,2018,41,92,279,371
6035,LASSEN,2018,42,107,285,392
6035,LASSEN,2018,43,102,293,395
6035,LASSEN,2018,44,94,240,334
6035,LASSEN,2018,45,118,279,397
6035,LASSEN,2018,46,113,258,371
6035,LASSEN,2018,47,157,273,430
6035,LASSEN,2018,48,141,338,479
6035,LASSEN,2018,49,143,253,396
6035,LASSEN,2018,50,151,235,386
6035,LASSEN,2018,51,131,241,372
6035,LASSEN,2018,52,164,220,384
6035,LASSEN,2018,53,189,290,479
6035,LASSEN,2018,54,170,259,429
6035,LASSEN,2018,55,202,228,430
6035,LASSEN,2018,56,170,247,417
6035,LASSEN,2018,57,195,209,404
6035,LASSEN,2018,58,201,231,432
6035,LASSEN,2018,59,214,240,454
6035,LASSEN,2018,60,197,253,450
6035,LASSEN,2018,61,176,196,372
6035,LASSEN,2018,62,221,174,395
6035,LASSEN,2018,63,221,199,420
6035,LASSEN,2018,64,201,206,407
6035,LASSEN,2018,65,209,229,438
6035,LASSEN,2018,66,188,205,393
6035,LASSEN,2018,67,184,190,374
6035,LASSEN,2018,68,164,190,354
6035,LASSEN,2018,69,169,175,344
6035,LASSEN,2018,70,161,177,338
6035,LASSEN,2018,71,173,160,333
6035,LASSEN,2018,72,136,119,255
6035,LASSEN,2018,73,114,111,225
6035,LASSEN,2018,74,113,118,231
6035,LASSEN,2018,75,115,112,227
6035,LASSEN,2018,76,109,89,198
6035,LASSEN,2018,77,84,76,160
6035,LASSEN,2018,78,77,70,147
6035,LASSEN,2018,79,85,71,156
6035,LASSEN,2018,80,61,61,122
6035,LASSEN,2018,81,56,48,104
6035,LASSEN,2018,82,61,56,117
6035,LASSEN,2018,83,43,48,91
6035,LASSEN,2018,84,37,37,74
6035,LASSEN,2018,85,37,47,84
6035,LASSEN,2018,86,49,27,76
6035,LASSEN,2018,87,32,27,59
6035,LASSEN,2018,88,41,31,72
6035,LASSEN,2018,89,31,10,41
6035,LASSEN,2018,90,23,24,47
6035,LASSEN,2018,91,25,19,44
6035,LASSEN,2018,92,13,8,21
6035,LASSEN,2018,93,20,18,38
6035,LASSEN,2018,94,22,5,27
6035,LASSEN,2018,95,5,4,9
6035,LASSEN,2018,96,9,5,14
6035,LASSEN,2018,97,5,1,6
6035,LASSEN,2018,98,4,3,7
6035,LASSEN,2018,99,5,0,5
6035,LASSEN,2018,100,5,1,6
6035,LASSEN,2019,0,156,144,300
6035,LASSEN,2019,1,141,153,294
6035,LASSEN,2019,2,137,159,296
6035,LASSEN,2019,3,142,147,289
6035,LASSEN,2019,4,146,154,300
6035,LASSEN,2019,5,163,155,318
6035,LASSEN,2019,6,129,156,285
6035,LASSEN,2019,7,148,150,298
6035,LASSEN,2019,8,163,151,314
6035,LASSEN,2019,9,160,161,321
6035,LASSEN,2019,10,170,158,328
6035,LASSEN,2019,11,141,152,293
6035,LASSEN,2019,12,126,157,283
6035,LASSEN,2019,13,120,156,276
6035,LASSEN,2019,14,107,126,233
6035,LASSEN,2019,15,120,149,269
6035,LASSEN,2019,16,126,140,266
6035,LASSEN,2019,17,131,151,282
6035,LASSEN,2019,18,138,225,363
6035,LASSEN,2019,19,160,227,387
6035,LASSEN,2019,20,146,341,487
6035,LASSEN,2019,21,146,399,545
6035,LASSEN,2019,22,173,392,565
6035,LASSEN,2019,23,135,362,497
6035,LASSEN,2019,24,138,377,515
6035,LASSEN,2019,25,118,415,533
6035,LASSEN,2019,26,134,424,558
6035,LASSEN,2019,27,124,445,569
6035,LASSEN,2019,28,105,440,545
6035,LASSEN,2019,29,91,420,511
6035,LASSEN,2019,30,85,363,448
6035,LASSEN,2019,31,81,364,445
6035,LASSEN,2019,32,79,304,383
6035,LASSEN,2019,33,72,334,406
6035,LASSEN,2019,34,119,300,419
6035,LASSEN,2019,35,85,290,375
6035,LASSEN,2019,36,90,296,386
6035,LASSEN,2019,37,82,289,371
6035,LASSEN,2019,38,98,290,388
6035,LASSEN,2019,39,78,296,374
6035,LASSEN,2019,40,100,267,367
6035,LASSEN,2019,41,82,272,354
6035,LASSEN,2019,42,93,259,352
6035,LASSEN,2019,43,105,292,397
6035,LASSEN,2019,44,101,282,383
6035,LASSEN,2019,45,94,241,335
6035,LASSEN,2019,46,115,253,368
6035,LASSEN,2019,47,112,266,378
6035,LASSEN,2019,48,157,286,443
6035,LASSEN,2019,49,141,304,445
6035,LASSEN,2019,50,145,211,356
6035,LASSEN,2019,51,148,234,382
6035,LASSEN,2019,52,130,243,373
6035,LASSEN,2019,53,165,223,388
6035,LASSEN,2019,54,189,271,460
6035,LASSEN,2019,55,169,216,385
6035,LASSEN,2019,56,201,224,425
6035,LASSEN,2019,57,171,250,421
6035,LASSEN,2019,58,194,205,399
6035,LASSEN,2019,59,202,229,431
6035,LASSEN,2019,60,213,229,442
6035,LASSEN,2019,61,194,240,434
6035,LASSEN,2019,62,176,192,368
6035,LASSEN,2019,63,219,173,392
6035,LASSEN,2019,64,218,193,411
6035,LASSEN,2019,65,199,201,400
6035,LASSEN,2019,66,203,233,436
6035,LASSEN,2019,67,187,193,380
6035,LASSEN,2019,68,182,183,365
6035,LASSEN,2019,69,163,186,349
6035,LASSEN,2019,70,168,172,340
6035,LASSEN,2019,71,159,172,331
6035,LASSEN,2019,72,169,150,319
6035,LASSEN,2019,73,133,109,242
6035,LASSEN,2019,74,115,109,224
6035,LASSEN,2019,75,109,114,223
6035,LASSEN,2019,76,111,109,220
6035,LASSEN,2019,77,107,85,192
6035,LASSEN,2019,78,86,74,160
6035,LASSEN,2019,79,73,68,141
6035,LASSEN,2019,80,84,67,151
6035,LASSEN,2019,81,58,59,117
6035,LASSEN,2019,82,52,44,96
6035,LASSEN,2019,83,56,52,108
6035,LASSEN,2019,84,43,44,87
6035,LASSEN,2019,85,35,37,72
6035,LASSEN,2019,86,40,42,82
6035,LASSEN,2019,87,42,23,65
6035,LASSEN,2019,88,29,24,53
6035,LASSEN,2019,89,36,25,61
6035,LASSEN,2019,90,31,11,42
6035,LASSEN,2019,91,16,18,34
6035,LASSEN,2019,92,23,14,37
6035,LASSEN,2019,93,10,6,16
6035,LASSEN,2019,94,14,19,33
6035,LASSEN,2019,95,22,2,24
6035,LASSEN,2019,96,2,3,5
6035,LASSEN,2019,97,7,5,12
6035,LASSEN,2019,98,3,1,4
6035,LASSEN,2019,99,2,3,5
6035,LASSEN,2019,100,7,1,8
6037,LOS ANGELES,2017,0,58338,64143,122481
6037,LOS ANGELES,2017,1,59233,62226,121459
6037,LOS ANGELES,2017,2,61754,65343,127097
6037,LOS ANGELES,2017,3,62067,65903,127970
6037,LOS ANGELES,2017,4,63093,66325,129418
6037,LOS ANGELES,2017,5,62448,65521,127969
6037,LOS ANGELES,2017,6,63942,67067,131009
6037,LOS ANGELES,2017,7,61920,64845,126765
6037,LOS ANGELES,2017,8,61907,65042,126949
6037,LOS ANGELES,2017,9,64002,66602,130604
6037,LOS ANGELES,2017,10,63461,66917,130378
6037,LOS ANGELES,2017,11,62422,65160,127582
6037,LOS ANGELES,2017,12,62102,64547,126649
6037,LOS ANGELES,2017,13,61314,64325,125639
6037,LOS ANGELES,2017,14,60968,64020,124988
6037,LOS ANGELES,2017,15,61529,63820,125349
6037,LOS ANGELES,2017,16,63561,66037,129598
6037,LOS ANGELES,2017,17,65466,68462,133928
6037,LOS ANGELES,2017,18,76917,79233,156150
6037,LOS ANGELES,2017,19,80829,84059,164888
6037,LOS ANGELES,2017,20,79149,83385,162534
6037,LOS ANGELES,2017,21,80257,84642,164899
6037,LOS ANGELES,2017,22,78779,82482,161261
6037,LOS ANGELES,2017,23,77753,81813,159566
6037,LOS ANGELES,2017,24,77150,81668,158818
6037,LOS ANGELES,2017,25,72582,77078,149660
6037,LOS ANGELES,2017,26,67243,70326,137569
6037,LOS ANGELES,2017,27,64296,67254,131550
6037,LOS ANGELES,2017,28,63094,66060,129154
6037,LOS ANGELES,2017,29,62879,66173,129052
6037,LOS ANGELES,2017,30,64698,68191,132889
6037,LOS ANGELES,2017,31,66715,70170,136885
6037,LOS ANGELES,2017,32,69972,72748,142720
6037,LOS ANGELES,2017,33,71416,74264,145680
6037,LOS ANGELES,2017,34,73281,75889,149170
6037,LOS ANGELES,2017,35,73981,75894,149875
6037,LOS ANGELES,2017,36,73380,74998,148378
6037,LOS ANGELES,2017,37,73767,75858,149625
6037,LOS ANGELES,2017,38,69588,70678,140266
6037,LOS ANGELES,2017,39,69158,69516,138674
6037,LOS ANGELES,2017,40,68644,68660,137304
6037,LOS ANGELES,2017,41,68619,67970,136589
6037,LOS ANGELES,2017,42,70702,70389,141091
6037,LOS ANGELES,2017,43,68970,68427,137397
6037,LOS ANGELES,2017,44,69457,68685,138142
6037,LOS ANGELES,2017,45,70954,70157,141111
6037,LOS ANGELES,2017,46,74147,72828,146975
6037,LOS ANGELES,2017,47,76294,76603,152897
6037,LOS ANGELES,2017,48,72189,71792,143981
6037,LOS ANGELES,2017,49,69191,69457,138648
6037,LOS ANGELES,2017,50,68652,67663,136315
6037,LOS ANGELES,2017,51,68397,66989,135386
6037,LOS ANGELES,2017,52,70694,69946,140640
6037,LOS ANGELES,2017,53,70772,68456,139228
6037,LOS ANGELES,2017,54,70346,68128,138474
6037,LOS ANGELES,2017,55,68229,65855,134084
6037,LOS ANGELES,2017,56,68981,65610,134591
6037,LOS ANGELES,2017,57,69806,66787,136593
6037,LOS ANGELES,2017,58,66239,62869,129108
6037,LOS ANGELES,2017,59,65937,61510,127447
6037,LOS ANGELES,2017,60,64263,58934,123197
6037,LOS ANGELES,2017,61,63260,57271,120531
6037,LOS ANGELES,2017,62,62820,57039,119859
6037,LOS ANGELES,2017,63,58727,52748,111475
6037,LOS ANGELES,2017,64,55579,49562,105141
6037,LOS ANGELES,2017,65,53185,46787,99972
6037,LOS ANGELES,2017,66,51425,44698,96123
6037,LOS ANGELES,2017,67,50926,43485,94411
6037,LOS ANGELES,2017,68,47962,40156,88118
6037,LOS ANGELES,2017,69,46502,39659,86161
6037,LOS ANGELES,2017,70,44536,38151,82687
6037,LOS ANGELES,2017,71,38629,32103,70732
6037,LOS ANGELES,2017,72,36514,29858,66372
6037,LOS ANGELES,2017,73,34069,27778,61847
6037,LOS ANGELES,2017,74,33197,26266,59463
6037,LOS ANGELES,2017,75,30483,23996,54479
6037,LOS ANGELES,2017,76,27962,21725,49687
6037,LOS ANGELES,2017,77,26680,20751,47431
6037,LOS ANGELES,2017,78,24835,18757,43592
6037,LOS ANGELES,2017,79,23740,17720,41460
6037,LOS ANGELES,2017,80,22808,16611,39419
6037,LOS ANGELES,2017,81,21665,15225,36890
6037,LOS ANGELES,2017,82,20140,13890,34030
6037,LOS ANGELES,2017,83,18355,12194,30549
6037,LOS ANGELES,2017,84,17427,11619,29046
6037,LOS ANGELES,2017,85,17343,10934,28277
6037,LOS ANGELES,2017,86,16726,10221,26947
6037,LOS ANGELES,2017,87,15060,9142,24202
6037,LOS ANGELES,2017,88,13173,7570,20743
6037,LOS ANGELES,2017,89,12368,6817,19185
6037,LOS ANGELES,2017,90,11205,6008,17213
6037,LOS ANGELES,2017,91,9532,4782,14314
6037,LOS ANGELES,2017,92,7456,3644,11100
6037,LOS ANGELES,2017,93,5606,2739,8345
6037,LOS ANGELES,2017,94,4807,2246,7053
6037,LOS ANGELES,2017,95,3959,1759,5718
6037,LOS ANGELES,2017,96,2854,1244,4098
6037,LOS ANGELES,2017,97,1911,757,2668
6037,LOS ANGELES,2017,98,1304,468,1772
6037,LOS ANGELES,2017,99,893,376,1269
6037,LOS ANGELES,2017,100,1368,475,1843
6037,LOS ANGELES,2018,0,57005,62763,119768
6037,LOS ANGELES,2018,1,58097,63844,121941
6037,LOS ANGELES,2018,2,59213,62223,121436
6037,LOS ANGELES,2018,3,61730,65333,127063
6037,LOS ANGELES,2018,4,62032,65875,127907
6037,LOS ANGELES,2018,5,63064,66283,129347
6037,LOS ANGELES,2018,6,62421,65512,127933
6037,LOS ANGELES,2018,7,63927,67042,130969
6037,LOS ANGELES,2018,8,61921,64828,126749
6037,LOS ANGELES,2018,9,61883,65023,126906
6037,LOS ANGELES,2018,10,64015,66666,130681
6037,LOS ANGELES,2018,11,63462,66928,130390
6037,LOS ANGELES,2018,12,62401,65122,127523
6037,LOS ANGELES,2018,13,62108,64573,126681
6037,LOS ANGELES,2018,14,61301,64275,125576
6037,LOS ANGELES,2018,15,61184,64122,125306
6037,LOS ANGELES,2018,16,61762,64074,125836
6037,LOS ANGELES,2018,17,64665,66964,131629
6037,LOS ANGELES,2018,18,77026,80189,157215
6037,LOS ANGELES,2018,19,80258,82683,162941
6037,LOS ANGELES,2018,20,77563,82134,159697
6037,LOS ANGELES,2018,21,78451,82409,160860
6037,LOS ANGELES,2018,22,79508,83280,162788
6037,LOS ANGELES,2018,23,77018,80753,157771
6037,LOS ANGELES,2018,24,76294,80539,156833
6037,LOS ANGELES,2018,25,74469,79072,153541
6037,LOS ANGELES,2018,26,68592,72840,141432
6037,LOS ANGELES,2018,27,67143,70195,137338
6037,LOS ANGELES,2018,28,64272,67151,131423
6037,LOS ANGELES,2018,29,62793,65732,128525
6037,LOS ANGELES,2018,30,62901,66266,129167
6037,LOS ANGELES,2018,31,64557,67825,132382
6037,LOS ANGELES,2018,32,66589,70016,136605
6037,LOS ANGELES,2018,33,69608,72342,141950
6037,LOS ANGELES,2018,34,71440,74278,145718
6037,LOS ANGELES,2018,35,73222,75633,148855
6037,LOS ANGELES,2018,36,73286,75169,148455
6037,LOS ANGELES,2018,37,73360,74854,148214
6037,LOS ANGELES,2018,38,73728,75772,149500
6037,LOS ANGELES,2018,39,69540,70683,140223
6037,LOS ANGELES,2018,40,69126,69532,138658
6037,LOS ANGELES,2018,41,68522,68486,137008
6037,LOS ANGELES,2018,42,68559,67850,136409
6037,LOS ANGELES,2018,43,70578,70210,140788
6037,LOS ANGELES,2018,44,68888,68448,137336
6037,LOS ANGELES,2018,45,69533,68719,138252
6037,LOS ANGELES,2018,46,70856,69925,140781
6037,LOS ANGELES,2018,47,73984,72632,146616
6037,LOS ANGELES,2018,48,76135,76383,152518
6037,LOS ANGELES,2018,49,72090,71649,143739
6037,LOS ANGELES,2018,50,69141,69356,138497
6037,LOS ANGELES,2018,51,68387,67115,135502
6037,LOS ANGELES,2018,52,68133,66679,134812
6037,LOS ANGELES,2018,53,70481,69507,139988
6037,LOS ANGELES,2018,54,70474,68023,138497
6037,LOS ANGELES,2018,55,70113,67718,137831
6037,LOS ANGELES,2018,56,67914,65247,133161
6037,LOS ANGELES,2018,57,68623,65031,133654
6037,LOS ANGELES,2018,58,69415,66296,135711
6037,LOS ANGELES,2018,59,65953,62278,128231
6037,LOS ANGELES,2018,60,65598,60900,126498
6037,LOS ANGELES,2018,61,63801,58241,122042
6037,LOS ANGELES,2018,62,62801,56557,119358
6037,LOS ANGELES,2018,63,62413,56470,118883
6037,LOS ANGELES,2018,64,58229,51943,110172
6037,LOS ANGELES,2018,65,55276,48987,104263
6037,LOS ANGELES,2018,66,52659,46042,98701
6037,LOS ANGELES,2018,67,50954,43990,94944
6037,LOS ANGELES,2018,68,50389,42902,93291
6037,LOS ANGELES,2018,69,47470,39521,86991
6037,LOS ANGELES,2018,70,46199,39102,85301
6037,LOS ANGELES,2018,71,43873,37267,81140
6037,LOS ANGELES,2018,72,38125,31421,69546
6037,LOS ANGELES,2018,73,35861,29113,64974
6037,LOS ANGELES,2018,74,33650,27172,60822
6037,LOS ANGELES,2018,75,32904,25806,58710
6037,LOS ANGELES,2018,76,29753,23108,52861
6037,LOS ANGELES,2018,77,27387,21045,48432
6037,LOS ANGELES,2018,78,26002,20050,46052
6037,LOS ANGELES,2018,79,24255,18094,42349
6037,LOS ANGELES,2018,80,23579,17276,40855
6037,LOS ANGELES,2018,81,21840,15674,37514
6037,LOS ANGELES,2018,82,20833,14418,35251
6037,LOS ANGELES,2018,83,19371,13137,32508
6037,LOS ANGELES,2018,84,17611,11493,29104
6037,LOS ANGELES,2018,85,17766,11300,29066
6037,LOS ANGELES,2018,86,16090,9973,26063
6037,LOS ANGELES,2018,87,15476,9312,24788
6037,LOS ANGELES,2018,88,14023,8366,22389
6037,LOS ANGELES,2018,89,12180,6926,19106
6037,LOS ANGELES,2018,90,11341,6156,17497
6037,LOS ANGELES,2018,91,9616,4896,14512
6037,LOS ANGELES,2018,92,8134,3917,12051
6037,LOS ANGELES,2018,93,6378,3021,9399
6037,LOS ANGELES,2018,94,4813,2262,7075
6037,LOS ANGELES,2018,95,4111,1845,5956
6037,LOS ANGELES,2018,96,3085,1278,4363
6037,LOS ANGELES,2018,97,2168,895,3063
6037,LOS ANGELES,2018,98,1492,563,2055
6037,LOS ANGELES,2018,99,1026,348,1374
6037,LOS ANGELES,2018,100,1571,585,2156
6037,LOS ANGELES,2019,0,56166,62160,118326
6037,LOS ANGELES,2019,1,56768,62497,119265
6037,LOS ANGELES,2019,2,58094,63838,121932
6037,LOS ANGELES,2019,3,59199,62225,121424
6037,LOS ANGELES,2019,4,61699,65306,127005
6037,LOS ANGELES,2019,5,62005,65828,127833
6037,LOS ANGELES,2019,6,63043,66277,129320
6037,LOS ANGELES,2019,7,62408,65496,127904
6037,LOS ANGELES,2019,8,63934,67032,130966
6037,LOS ANGELES,2019,9,61899,64812,126711
6037,LOS ANGELES,2019,10,61898,65092,126990
6037,LOS ANGELES,2019,11,64009,66680,130689
6037,LOS ANGELES,2019,12,63458,66887,130345
6037,LOS ANGELES,2019,13,62417,65157,127574
6037,LOS ANGELES,2019,14,62091,64519,126610
6037,LOS ANGELES,2019,15,61518,64374,125892
6037,LOS ANGELES,2019,16,61434,64387,125821
6037,LOS ANGELES,2019,17,62875,65043,127918
6037,LOS ANGELES,2019,18,76236,78722,154958
6037,LOS ANGELES,2019,19,80386,83663,164049
6037,LOS ANGELES,2019,20,77009,80765,157774
6037,LOS ANGELES,2019,21,76889,81154,158043
6037,LOS ANGELES,2019,22,77693,81044,158737
6037,LOS ANGELES,2019,23,77741,81539,159280
6037,LOS ANGELES,2019,24,75586,79505,155091
6037,LOS ANGELES,2019,25,73632,77948,151580
6037,LOS ANGELES,2019,26,70459,74850,145309
6037,LOS ANGELES,2019,27,68495,72705,141200
6037,LOS ANGELES,2019,28,67103,70107,137210
6037,LOS ANGELES,2019,29,63980,66824,130804
6037,LOS ANGELES,2019,30,62820,65836,128656
6037,LOS ANGELES,2019,31,62771,65900,128671
6037,LOS ANGELES,2019,32,64430,67685,132115
6037,LOS ANGELES,2019,33,66218,69612,135830
6037,LOS ANGELES,2019,34,69624,72354,141978
6037,LOS ANGELES,2019,35,71393,74007,145400
6037,LOS ANGELES,2019,36,72540,74918,147458
6037,LOS ANGELES,2019,37,73273,75050,148323
6037,LOS ANGELES,2019,38,73340,74756,148096
6037,LOS ANGELES,2019,39,73676,75767,149443
6037,LOS ANGELES,2019,40,69513,70716,140229
6037,LOS ANGELES,2019,41,69032,69357,138389
6037,LOS ANGELES,2019,42,68468,68369,136837
6037,LOS ANGELES,2019,43,68445,67701,136146
6037,LOS ANGELES,2019,44,70489,70206,140695
6037,LOS ANGELES,2019,45,68973,68483,137456
6037,LOS ANGELES,2019,46,69438,68458,137896
6037,LOS ANGELES,2019,47,70696,69720,140416
6037,LOS ANGELES,2019,48,73854,72453,146307
6037,LOS ANGELES,2019,49,76004,76259,152263
6037,LOS ANGELES,2019,50,72040,71558,143598
6037,LOS ANGELES,2019,51,68923,68854,137777
6037,LOS ANGELES,2019,52,68111,66838,134949
6037,LOS ANGELES,2019,53,67933,66254,134187
6037,LOS ANGELES,2019,54,70199,69104,139303
6037,LOS ANGELES,2019,55,70257,67625,137882
6037,LOS ANGELES,2019,56,69795,67159,136954
6037,LOS ANGELES,2019,57,67561,64657,132218
6037,LOS ANGELES,2019,58,68244,64545,132789
6037,LOS ANGELES,2019,59,69103,65752,134855
6037,LOS ANGELES,2019,60,65644,61624,127268
6037,LOS ANGELES,2019,61,65169,60197,125366
6037,LOS ANGELES,2019,62,63336,57526,120862
6037,LOS ANGELES,2019,63,62393,55986,118379
6037,LOS ANGELES,2019,64,61911,55651,117562
6037,LOS ANGELES,2019,65,57941,51355,109296
6037,LOS ANGELES,2019,66,54782,48209,102991
6037,LOS ANGELES,2019,67,52174,45315,97489
6037,LOS ANGELES,2019,68,50414,43345,93759
6037,LOS ANGELES,2019,69,49958,42189,92147
6037,LOS ANGELES,2019,70,47148,39000,86148
6037,LOS ANGELES,2019,71,45509,38234,83743
6037,LOS ANGELES,2019,72,43292,36543,79835
6037,LOS ANGELES,2019,73,37529,30653,68182
6037,LOS ANGELES,2019,74,35401,28491,63892
6037,LOS ANGELES,2019,75,33389,26673,60062
6037,LOS ANGELES,2019,76,32121,24955,57076
6037,LOS ANGELES,2019,77,29124,22383,51507
6037,LOS ANGELES,2019,78,26722,20370,47092
6037,LOS ANGELES,2019,79,25395,19381,44776
6037,LOS ANGELES,2019,80,24140,17711,41851
6037,LOS ANGELES,2019,81,22637,16268,38905
6037,LOS ANGELES,2019,82,21009,14788,35797
6037,LOS ANGELES,2019,83,20047,13631,33678
6037,LOS ANGELES,2019,84,18608,12427,31035
6037,LOS ANGELES,2019,85,17952,11110,29062
6037,LOS ANGELES,2019,86,16553,10313,26866
6037,LOS ANGELES,2019,87,14888,9092,23980
6037,LOS ANGELES,2019,88,14372,8499,22871
6037,LOS ANGELES,2019,89,13038,7604,20642
6037,LOS ANGELES,2019,90,11227,6293,17520
6037,LOS ANGELES,2019,91,9763,5024,14787
6037,LOS ANGELES,2019,92,8118,4021,12139
6037,LOS ANGELES,2019,93,6964,3258,10222
6037,LOS ANGELES,2019,94,5516,2459,7975
6037,LOS ANGELES,2019,95,4133,1841,5974
6037,LOS ANGELES,2019,96,3164,1349,4513
6037,LOS ANGELES,2019,97,2354,932,3286
6037,LOS ANGELES,2019,98,1692,649,2341
6037,LOS ANGELES,2019,99,1146,408,1554
6037,LOS ANGELES,2019,100,1832,620,2452
6039,MADERA,2017,0,1066,1221,2287
6039,MADERA,2017,1,1102,1150,2252
6039,MADERA,2017,2,1139,1139,2278
6039,MADERA,2017,3,1084,1170,2254
6039,MADERA,2017,4,1105,1155,2260
6039,MADERA,2017,5,1166,1174,2340
6039,MADERA,2017,6,1178,1261,2439
6039,MADERA,2017,7,1110,1178,2288
6039,MADERA,2017,8,1164,1213,2377
6039,MADERA,2017,9,1204,1187,2391
6039,MADERA,2017,10,1282,1214,2496
6039,MADERA,2017,11,1161,1268,2429
6039,MADERA,2017,12,1194,1206,2400
6039,MADERA,2017,13,1206,1191,2397
6039,MADERA,2017,14,1169,1130,2299
6039,MADERA,2017,15,1194,1178,2372
6039,MADERA,2017,16,1156,1239,2395
6039,MADERA,2017,17,1073,1296,2369
6039,MADERA,2017,18,1167,1250,2417
6039,MADERA,2017,19,1156,1182,2338
6039,MADERA,2017,20,1302,1213,2515
6039,MADERA,2017,21,1331,1239,2570
6039,MADERA,2017,22,1233,1197,2430
6039,MADERA,2017,23,1290,1224,2514
6039,MADERA,2017,24,1259,1235,2494
6039,MADERA,2017,25,1291,1292,2583
6039,MADERA,2017,26,1276,1264,2540
6039,MADERA,2017,27,1107,1124,2231
6039,MADERA,2017,28,1040,1067,2107
6039,MADERA,2017,29,1143,1096,2239
6039,MADERA,2017,30,1086,1034,2120
6039,MADERA,2017,31,1162,1032,2194
6039,MADERA,2017,32,1078,945,2023
6039,MADERA,2017,33,1006,1022,2028
6039,MADERA,2017,34,1133,976,2109
6039,MADERA,2017,35,1106,929,2035
6039,MADERA,2017,36,1047,901,1948
6039,MADERA,2017,37,1056,949,2005
6039,MADERA,2017,38,1040,928,1968
6039,MADERA,2017,39,1058,862,1920
6039,MADERA,2017,40,1077,825,1902
6039,MADERA,2017,41,978,793,1771
6039,MADERA,2017,42,1025,853,1878
6039,MADERA,2017,43,994,810,1804
6039,MADERA,2017,44,942,836,1778
6039,MADERA,2017,45,967,808,1775
6039,MADERA,2017,46,1043,847,1890
6039,MADERA,2017,47,1039,883,1922
6039,MADERA,2017,48,994,850,1844
6039,MADERA,2017,49,979,843,1822
6039,MADERA,2017,50,906,802,1708
6039,MADERA,2017,51,923,844,1767
6039,MADERA,2017,52,893,778,1671
6039,MADERA,2017,53,887,780,1667
6039,MADERA,2017,54,931,807,1738
6039,MADERA,2017,55,834,799,1633
6039,MADERA,2017,56,840,806,1646
6039,MADERA,2017,57,919,885,1804
6039,MADERA,2017,58,925,805,1730
6039,MADERA,2017,59,884,830,1714
6039,MADERA,2017,60,831,782,1613
6039,MADERA,2017,61,796,855,1651
6039,MADERA,2017,62,829,784,1613
6039,MADERA,2017,63,842,736,1578
6039,MADERA,2017,64,831,746,1577
6039,MADERA,2017,65,757,728,1485
6039,MADERA,2017,66,794,687,1481
6039,MADERA,2017,67,738,769,1507
6039,MADERA,2017,68,699,656,1355
6039,MADERA,2017,69,724,631,1355
6039,MADERA,2017,70,689,654,1343
6039,MADERA,2017,71,572,503,1075
6039,MADERA,2017,72,567,499,1066
6039,MADERA,2017,73,596,475,1071
6039,MADERA,2017,74,493,482,975
6039,MADERA,2017,75,483,386,869
6039,MADERA,2017,76,488,426,914
6039,MADERA,2017,77,445,366,811
6039,MADERA,2017,78,406,364,770
6039,MADERA,2017,79,404,320,724
6039,MADERA,2017,80,334,283,617
6039,MADERA,2017,81,314,278,592
6039,MADERA,2017,82,320,226,546
6039,MADERA,2017,83,229,226,455
6039,MADERA,2017,84,232,217,449
6039,MADERA,2017,85,252,181,433
6039,MADERA,2017,86,230,180,410
6039,MADERA,2017,87,224,155,379
6039,MADERA,2017,88,160,110,270
6039,MADERA,2017,89,156,114,270
6039,MADERA,2017,90,113,111,224
6039,MADERA,2017,91,113,72,185
6039,MADERA,2017,92,92,54,146
6039,MADERA,2017,93,68,30,98
6039,MADERA,2017,94,67,41,108
6039,MADERA,2017,95,36,29,65
6039,MADERA,2017,96,21,17,38
6039,MADERA,2017,97,17,11,28
6039,MADERA,2017,98,5,2,7
6039,MADERA,2017,99,3,10,13
6039,MADERA,2017,100,10,5,15
6039,MADERA,2018,0,1040,1173,2213
6039,MADERA,2018,1,1059,1215,2274
6039,MADERA,2018,2,1100,1151,2251
6039,MADERA,2018,3,1138,1143,2281
6039,MADERA,2018,4,1086,1168,2254
6039,MADERA,2018,5,1103,1156,2259
6039,MADERA,2018,6,1167,1173,2340
6039,MADERA,2018,7,1185,1266,2451
6039,MADERA,2018,8,1107,1181,2288
6039,MADERA,2018,9,1166,1213,2379
6039,MADERA,2018,10,1205,1188,2393
6039,MADERA,2018,11,1282,1215,2497
6039,MADERA,2018,12,1161,1267,2428
6039,MADERA,2018,13,1194,1205,2399
6039,MADERA,2018,14,1209,1190,2399
6039,MADERA,2018,15,1193,1153,2346
6039,MADERA,2018,16,1201,1171,2372
6039,MADERA,2018,17,1159,1245,2404
6039,MADERA,2018,18,1076,1309,2385
6039,MADERA,2018,19,1188,1268,2456
6039,MADERA,2018,20,1280,1184,2464
6039,MADERA,2018,21,1324,1214,2538
6039,MADERA,2018,22,1301,1253,2554
6039,MADERA,2018,23,1296,1220,2516
6039,MADERA,2018,24,1273,1222,2495
6039,MADERA,2018,25,1317,1232,2549
6039,MADERA,2018,26,1285,1303,2588
6039,MADERA,2018,27,1285,1259,2544
6039,MADERA,2018,28,1118,1114,2232
6039,MADERA,2018,29,1043,1085,2128
6039,MADERA,2018,30,1135,1097,2232
6039,MADERA,2018,31,1104,1036,2140
6039,MADERA,2018,32,1142,1034,2176
6039,MADERA,2018,33,1078,943,2021
6039,MADERA,2018,34,1018,1018,2036
6039,MADERA,2018,35,1109,981,2090
6039,MADERA,2018,36,1114,925,2039
6039,MADERA,2018,37,1036,906,1942
6039,MADERA,2018,38,1087,960,2047
6039,MADERA,2018,39,1081,924,2005
6039,MADERA,2018,40,1049,858,1907
6039,MADERA,2018,41,1055,827,1882
6039,MADERA,2018,42,989,797,1786
6039,MADERA,2018,43,1028,848,1876
6039,MADERA,2018,44,968,815,1783
6039,MADERA,2018,45,933,835,1768
6039,MADERA,2018,46,1002,811,1813
6039,MADERA,2018,47,1031,865,1896
6039,MADERA,2018,48,1045,890,1935
6039,MADERA,2018,49,1047,865,1912
6039,MADERA,2018,50,876,874,1750
6039,MADERA,2018,51,912,797,1709
6039,MADERA,2018,52,924,831,1755
6039,MADERA,2018,53,881,781,1662
6039,MADERA,2018,54,911,781,1692
6039,MADERA,2018,55,852,802,1654
6039,MADERA,2018,56,819,794,1613
6039,MADERA,2018,57,842,794,1636
6039,MADERA,2018,58,926,883,1809
6039,MADERA,2018,59,915,788,1703
6039,MADERA,2018,60,843,815,1658
6039,MADERA,2018,61,821,778,1599
6039,MADERA,2018,62,791,847,1638
6039,MADERA,2018,63,824,797,1621
6039,MADERA,2018,64,848,718,1566
6039,MADERA,2018,65,814,745,1559
6039,MADERA,2018,66,754,720,1474
6039,MADERA,2018,67,780,682,1462
6039,MADERA,2018,68,738,766,1504
6039,MADERA,2018,69,692,642,1334
6039,MADERA,2018,70,719,619,1338
6039,MADERA,2018,71,674,645,1319
6039,MADERA,2018,72,567,488,1055
6039,MADERA,2018,73,566,486,1052
6039,MADERA,2018,74,586,467,1053
6039,MADERA,2018,75,491,470,961
6039,MADERA,2018,76,474,371,845
6039,MADERA,2018,77,488,416,904
6039,MADERA,2018,78,424,351,775
6039,MADERA,2018,79,401,354,755
6039,MADERA,2018,80,390,302,692
6039,MADERA,2018,81,324,260,584
6039,MADERA,2018,82,299,265,564
6039,MADERA,2018,83,304,209,513
6039,MADERA,2018,84,214,213,427
6039,MADERA,2018,85,231,202,433
6039,MADERA,2018,86,229,159,388
6039,MADERA,2018,87,224,168,392
6039,MADERA,2018,88,190,133,323
6039,MADERA,2018,89,153,101,254
6039,MADERA,2018,90,136,95,231
6039,MADERA,2018,91,105,96,201
6039,MADERA,2018,92,94,66,160
6039,MADERA,2018,93,77,40,117
6039,MADERA,2018,94,57,24,81
6039,MADERA,2018,95,56,34,90
6039,MADERA,2018,96,28,25,53
6039,MADERA,2018,97,14,9,23
6039,MADERA,2018,98,13,8,21
6039,MADERA,2018,99,6,2,8
6039,MADERA,2018,100,8,11,19
6039,MADERA,2019,0,1055,1160,2215
6039,MADERA,2019,1,1034,1167,2201
6039,MADERA,2019,2,1059,1215,2274
6039,MADERA,2019,3,1099,1154,2253
6039,MADERA,2019,4,1138,1140,2278
6039,MADERA,2019,5,1085,1170,2255
6039,MADERA,2019,6,1104,1154,2258
6039,MADERA,2019,7,1173,1178,2351
6039,MADERA,2019,8,1186,1273,2459
6039,MADERA,2019,9,1108,1181,2289
6039,MADERA,2019,10,1169,1214,2383
6039,MADERA,2019,11,1205,1192,2397
6039,MADERA,2019,12,1282,1215,2497
6039,MADERA,2019,13,1161,1266,2427
6039,MADERA,2019,14,1196,1203,2399
6039,MADERA,2019,15,1228,1216,2444
6039,MADERA,2019,16,1203,1149,2352
6039,MADERA,2019,17,1213,1183,2396
6039,MADERA,2019,18,1170,1260,2430
6039,MADERA,2019,19,1105,1323,2428
6039,MADERA,2019,20,1312,1268,2580
6039,MADERA,2019,21,1298,1189,2487
6039,MADERA,2019,22,1295,1231,2526
6039,MADERA,2019,23,1373,1282,2655
6039,MADERA,2019,24,1279,1217,2496
6039,MADERA,2019,25,1338,1225,2563
6039,MADERA,2019,26,1311,1244,2555
6039,MADERA,2019,27,1293,1297,2590
6039,MADERA,2019,28,1296,1257,2553
6039,MADERA,2019,29,1119,1132,2251
6039,MADERA,2019,30,1038,1088,2126
6039,MADERA,2019,31,1155,1104,2259
6039,MADERA,2019,32,1084,1037,2121
6039,MADERA,2019,33,1141,1028,2169
6039,MADERA,2019,34,1091,943,2034
6039,MADERA,2019,35,998,1022,2020
6039,MADERA,2019,36,1122,979,2101
6039,MADERA,2019,37,1112,925,2037
6039,MADERA,2019,38,1062,920,1982
6039,MADERA,2019,39,1125,961,2086
6039,MADERA,2019,40,1074,920,1994
6039,MADERA,2019,41,1027,862,1889
6039,MADERA,2019,42,1066,826,1892
6039,MADERA,2019,43,989,789,1778
6039,MADERA,2019,44,1000,858,1858
6039,MADERA,2019,45,957,813,1770
6039,MADERA,2019,46,968,845,1813
6039,MADERA,2019,47,1000,829,1829
6039,MADERA,2019,48,1055,878,1933
6039,MADERA,2019,49,1088,922,2010
6039,MADERA,2019,50,944,892,1836
6039,MADERA,2019,51,885,873,1758
6039,MADERA,2019,52,912,787,1699
6039,MADERA,2019,53,908,836,1744
6039,MADERA,2019,54,901,782,1683
6039,MADERA,2019,55,834,769,1603
6039,MADERA,2019,56,841,803,1644
6039,MADERA,2019,57,821,783,1604
6039,MADERA,2019,58,845,798,1643
6039,MADERA,2019,59,916,869,1785
6039,MADERA,2019,60,875,775,1650
6039,MADERA,2019,61,833,813,1646
6039,MADERA,2019,62,816,784,1600
6039,MADERA,2019,63,787,861,1648
6039,MADERA,2019,64,832,775,1607
6039,MADERA,2019,65,837,714,1551
6039,MADERA,2019,66,812,733,1545
6039,MADERA,2019,67,737,712,1449
6039,MADERA,2019,68,780,688,1468
6039,MADERA,2019,69,729,752,1481
6039,MADERA,2019,70,692,628,1320
6039,MADERA,2019,71,701,606,1307
6039,MADERA,2019,72,667,628,1295
6039,MADERA,2019,73,569,474,1043
6039,MADERA,2019,74,558,475,1033
6039,MADERA,2019,75,574,450,1024
6039,MADERA,2019,76,473,456,929
6039,MADERA,2019,77,466,368,834
6039,MADERA,2019,78,466,396,862
6039,MADERA,2019,79,414,339,753
6039,MADERA,2019,80,393,339,732
6039,MADERA,2019,81,374,284,658
6039,MADERA,2019,82,307,249,556
6039,MADERA,2019,83,285,251,536
6039,MADERA,2019,84,296,197,493
6039,MADERA,2019,85,213,200,413
6039,MADERA,2019,86,203,187,390
6039,MADERA,2019,87,222,150,372
6039,MADERA,2019,88,183,157,340
6039,MADERA,2019,89,181,127,308
6039,MADERA,2019,90,130,88,218
6039,MADERA,2019,91,113,80,193
6039,MADERA,2019,92,89,77,166
6039,MADERA,2019,93,78,53,131
6039,MADERA,2019,94,68,32,100
6039,MADERA,2019,95,48,19,67
6039,MADERA,2019,96,39,23,62
6039,MADERA,2019,97,20,19,39
6039,MADERA,2019,98,6,6,12
6039,MADERA,2019,99,9,6,15
6039,MADERA,2019,100,7,9,16
6041,MARIN,2017,0,1112,1214,2326
6041,MARIN,2017,1,1102,1177,2279
6041,MARIN,2017,2,1138,1174,2312
6041,MARIN,2017,3,1244,1228,2472
6041,MARIN,2017,4,1188,1186,2374
6041,MARIN,2017,5,1168,1232,2400
6041,MARIN,2017,6,1225,1316,2541
6041,MARIN,2017,7,1336,1424,2760
6041,MARIN,2017,8,1459,1507,2966
6041,MARIN,2017,9,1575,1709,3284
6041,MARIN,2017,10,1632,1719,3351
6041,MARIN,2017,11,1661,1762,3423
6041,MARIN,2017,12,1786,1878,3664
6041,MARIN,2017,13,1788,1790,3578
6041,MARIN,2017,14,1700,1821,3521
6041,MARIN,2017,15,1647,1645,3292
6041,MARIN,2017,16,1503,1572,3075
6041,MARIN,2017,17,1462,1452,2914
6041,MARIN,2017,18,1401,1392,2793
6041,MARIN,2017,19,1287,1202,2489
6041,MARIN,2017,20,1201,1275,2476
6041,MARIN,2017,21,1308,1359,2667
6041,MARIN,2017,22,1153,1324,2477
6041,MARIN,2017,23,1173,1310,2483
6041,MARIN,2017,24,1284,1441,2725
6041,MARIN,2017,25,1116,1408,2524
6041,MARIN,2017,26,895,1201,2096
6041,MARIN,2017,27,1002,1134,2136
6041,MARIN,2017,28,951,1212,2163
6041,MARIN,2017,29,1009,1233,2242
6041,MARIN,2017,30,1043,1336,2379
6041,MARIN,2017,31,1022,1276,2298
6041,MARIN,2017,32,1075,1239,2314
6041,MARIN,2017,33,1047,1293,2340
6041,MARIN,2017,34,1159,1292,2451
6041,MARIN,2017,35,1133,1308,2441
6041,MARIN,2017,36,1215,1356,2571
6041,MARIN,2017,37,1400,1493,2893
6041,MARIN,2017,38,1332,1462,2794
6041,MARIN,2017,39,1447,1530,2977
6041,MARIN,2017,40,1542,1625,3167
6041,MARIN,2017,41,1692,1625,3317
6041,MARIN,2017,42,1804,1868,3672
6041,MARIN,2017,43,1756,1983,3739
6041,MARIN,2017,44,1856,1988,3844
6041,MARIN,2017,45,1897,2016,3913
6041,MARIN,2017,46,2060,2114,4174
6041,MARIN,2017,47,2188,2225,4413
6041,MARIN,2017,48,2099,2086,4185
6041,MARIN,2017,49,1985,2150,4135
6041,MARIN,2017,50,1976,1998,3974
6041,MARIN,2017,51,2109,1882,3991
6041,MARIN,2017,52,2062,2040,4102
6041,MARIN,2017,53,2070,1916,3986
6041,MARIN,2017,54,2074,1977,4051
6041,MARIN,2017,55,2056,1916,3972
6041,MARIN,2017,56,2157,2001,4158
6041,MARIN,2017,57,2208,2070,4278
6041,MARIN,2017,58,2120,1855,3975
6041,MARIN,2017,59,2131,1897,4028
6041,MARIN,2017,60,2052,1745,3797
6041,MARIN,2017,61,2062,1841,3903
6041,MARIN,2017,62,2089,1790,3879
6041,MARIN,2017,63,2110,1843,3953
6041,MARIN,2017,64,2161,1866,4027
6041,MARIN,2017,65,2047,1804,3851
6041,MARIN,2017,66,1967,1706,3673
6041,MARIN,2017,67,2069,1751,3820
6041,MARIN,2017,68,1983,1715,3698
6041,MARIN,2017,69,2045,1780,3825
6041,MARIN,2017,70,2080,1781,3861
6041,MARIN,2017,71,1805,1464,3269
6041,MARIN,2017,72,1594,1428,3022
6041,MARIN,2017,73,1500,1411,2911
6041,MARIN,2017,74,1540,1338,2878
6041,MARIN,2017,75,1273,1162,2435
6041,MARIN,2017,76,1088,926,2014
6041,MARIN,2017,77,1072,800,1872
6041,MARIN,2017,78,933,821,1754
6041,MARIN,2017,79,880,773,1653
6041,MARIN,2017,80,832,646,1478
6041,MARIN,2017,81,731,627,1358
6041,MARIN,2017,82,673,620,1293
6041,MARIN,2017,83,640,470,1110
6041,MARIN,2017,84,603,490,1093
6041,MARIN,2017,85,596,451,1047
6041,MARIN,2017,86,644,423,1067
6041,MARIN,2017,87,599,363,962
6041,MARIN,2017,88,526,325,851
6041,MARIN,2017,89,482,300,782
6041,MARIN,2017,90,410,249,659
6041,MARIN,2017,91,366,186,552
6041,MARIN,2017,92,274,142,416
6041,MARIN,2017,93,260,101,361
6041,MARIN,2017,94,189,78,267
6041,MARIN,2017,95,161,52,213
6041,MARIN,2017,96,109,62,171
6041,MARIN,2017,97,83,26,109
6041,MARIN,2017,98,57,21,78
6041,MARIN,2017,99,29,8,37
6041,MARIN,2017,100,61,18,79
6041,MARIN,2018,0,1025,1123,2148
6041,MARIN,2018,1,1108,1210,2318
6041,MARIN,2018,2,1106,1188,2294
6041,MARIN,2018,3,1152,1179,2331
6041,MARIN,2018,4,1245,1240,2485
6041,MARIN,2018,5,1192,1198,2390
6041,MARIN,2018,6,1202,1277,2479
6041,MARIN,2018,7,1279,1359,2638
6041,MARIN,2018,8,1359,1465,2824
6041,MARIN,2018,9,1493,1529,3022
6041,MARIN,2018,10,1593,1732,3325
6041,MARIN,2018,11,1648,1730,3378
6041,MARIN,2018,12,1663,1772,3435
6041,MARIN,2018,13,1804,1884,3688
6041,MARIN,2018,14,1791,1806,3597
6041,MARIN,2018,15,1712,1813,3525
6041,MARIN,2018,16,1594,1573,3167
6041,MARIN,2018,17,1420,1512,2932
6041,MARIN,2018,18,1550,1495,3045
6041,MARIN,2018,19,1245,1265,2510
6041,MARIN,2018,20,1209,1214,2423
6041,MARIN,2018,21,1223,1303,2526
6041,MARIN,2018,22,1329,1390,2719
6041,MARIN,2018,23,1183,1333,2516
6041,MARIN,2018,24,1213,1331,2544
6041,MARIN,2018,25,1288,1486,2774
6041,MARIN,2018,26,1104,1412,2516
6041,MARIN,2018,27,898,1203,2101
6041,MARIN,2018,28,1009,1126,2135
6041,MARIN,2018,29,944,1241,2185
6041,MARIN,2018,30,1013,1227,2240
6041,MARIN,2018,31,1039,1313,2352
6041,MARIN,2018,32,1038,1298,2336
6041,MARIN,2018,33,1090,1245,2335
6041,MARIN,2018,34,1056,1270,2326
6041,MARIN,2018,35,1153,1297,2450
6041,MARIN,2018,36,1182,1363,2545
6041,MARIN,2018,37,1254,1417,2671
6041,MARIN,2018,38,1446,1526,2972
6041,MARIN,2018,39,1379,1535,2914
6041,MARIN,2018,40,1476,1626,3102
6041,MARIN,2018,41,1556,1636,3192
6041,MARIN,2018,42,1720,1669,3389
6041,MARIN,2018,43,1817,1865,3682
6041,MARIN,2018,44,1763,2075,3838
6041,MARIN,2018,45,1868,1956,3824
6041,MARIN,2018,46,1896,2014,3910
6041,MARIN,2018,47,2055,2129,4184
6041,MARIN,2018,48,2175,2220,4395
6041,MARIN,2018,49,2103,2064,4167
6041,MARIN,2018,50,1991,2120,4111
6041,MARIN,2018,51,1967,1982,3949
6041,MARIN,2018,52,2097,1885,3982
6041,MARIN,2018,53,2058,2033,4091
6041,MARIN,2018,54,2066,1925,3991
6041,MARIN,2018,55,2072,1925,3997
6041,MARIN,2018,56,2027,1898,3925
6041,MARIN,2018,57,2136,1950,4086
6041,MARIN,2018,58,2193,2030,4223
6041,MARIN,2018,59,2091,1865,3956
6041,MARIN,2018,60,2103,1828,3931
6041,MARIN,2018,61,2044,1721,3765
6041,MARIN,2018,62,2050,1830,3880
6041,MARIN,2018,63,2069,1772,3841
6041,MARIN,2018,64,2102,1829,3931
6041,MARIN,2018,65,2148,1840,3988
6041,MARIN,2018,66,2027,1773,3800
6041,MARIN,2018,67,1963,1702,3665
6041,MARIN,2018,68,2065,1741,3806
6041,MARIN,2018,69,1965,1689,3654
6041,MARIN,2018,70,2028,1774,3802
6041,MARIN,2018,71,2056,1752,3808
6041,MARIN,2018,72,1785,1446,3231
6041,MARIN,2018,73,1571,1406,2977
6041,MARIN,2018,74,1484,1378,2862
6041,MARIN,2018,75,1526,1311,2837
6041,MARIN,2018,76,1249,1127,2376
6041,MARIN,2018,77,1067,917,1984
6041,MARIN,2018,78,1060,772,1832
6041,MARIN,2018,79,908,805,1713
6041,MARIN,2018,80,880,757,1637
6041,MARIN,2018,81,808,614,1422
6041,MARIN,2018,82,706,600,1306
6041,MARIN,2018,83,638,578,1216
6041,MARIN,2018,84,633,446,1079
6041,MARIN,2018,85,619,496,1115
6041,MARIN,2018,86,563,403,966
6041,MARIN,2018,87,605,387,992
6041,MARIN,2018,88,553,325,878
6041,MARIN,2018,89,483,303,786
6041,MARIN,2018,90,446,281,727
6041,MARIN,2018,91,340,177,517
6041,MARIN,2018,92,317,152,469
6041,MARIN,2018,93,222,114,336
6041,MARIN,2018,94,218,81,299
6041,MARIN,2018,95,155,66,221
6041,MARIN,2018,96,123,41,164
6041,MARIN,2018,97,73,46,119
6041,MARIN,2018,98,62,20,82
6041,MARIN,2018,99,49,19,68
6041,MARIN,2018,100,60,15,75
6041,MARIN,2019,0,1033,1165,2198
6041,MARIN,2019,1,1023,1115,2138
6041,MARIN,2019,2,1111,1224,2335
6041,MARIN,2019,3,1122,1193,2315
6041,MARIN,2019,4,1155,1192,2347
6041,MARIN,2019,5,1245,1250,2495
6041,MARIN,2019,6,1230,1246,2476
6041,MARIN,2019,7,1264,1320,2584
6041,MARIN,2019,8,1311,1398,2709
6041,MARIN,2019,9,1389,1486,2875
6041,MARIN,2019,10,1502,1545,3047
6041,MARIN,2019,11,1609,1746,3355
6041,MARIN,2019,12,1653,1736,3389
6041,MARIN,2019,13,1681,1779,3460
6041,MARIN,2019,14,1806,1901,3707
6041,MARIN,2019,15,1798,1800,3598
6041,MARIN,2019,16,1654,1731,3385
6041,MARIN,2019,17,1541,1511,3052
6041,MARIN,2019,18,1507,1553,3060
6041,MARIN,2019,19,1389,1369,2758
6041,MARIN,2019,20,1174,1262,2436
6041,MARIN,2019,21,1238,1241,2479
6041,MARIN,2019,22,1237,1332,2569
6041,MARIN,2019,23,1366,1397,2763
6041,MARIN,2019,24,1213,1366,2579
6041,MARIN,2019,25,1213,1377,2590
6041,MARIN,2019,26,1280,1487,2767
6041,MARIN,2019,27,1106,1416,2522
6041,MARIN,2019,28,904,1194,2098
6041,MARIN,2019,29,1000,1153,2153
6041,MARIN,2019,30,948,1235,2183
6041,MARIN,2019,31,1007,1205,2212
6041,MARIN,2019,32,1056,1337,2393
6041,MARIN,2019,33,1044,1299,2343
6041,MARIN,2019,34,1099,1225,2324
6041,MARIN,2019,35,1047,1285,2332
6041,MARIN,2019,36,1194,1369,2563
6041,MARIN,2019,37,1229,1418,2647
6041,MARIN,2019,38,1307,1438,2745
6041,MARIN,2019,39,1506,1589,3095
6041,MARIN,2019,40,1416,1618,3034
6041,MARIN,2019,41,1489,1652,3141
6041,MARIN,2019,42,1576,1675,3251
6041,MARIN,2019,43,1734,1677,3411
6041,MARIN,2019,44,1830,1944,3774
6041,MARIN,2019,45,1774,2043,3817
6041,MARIN,2019,46,1869,1957,3826
6041,MARIN,2019,47,1891,2031,3922
6041,MARIN,2019,48,2046,2122,4168
6041,MARIN,2019,49,2177,2199,4376
6041,MARIN,2019,50,2108,2032,4140
6041,MARIN,2019,51,1982,2101,4083
6041,MARIN,2019,52,1959,1983,3942
6041,MARIN,2019,53,2090,1885,3975
6041,MARIN,2019,54,2053,2038,4091
6041,MARIN,2019,55,2060,1866,3926
6041,MARIN,2019,56,2049,1912,3961
6041,MARIN,2019,57,2007,1856,3863
6041,MARIN,2019,58,2118,1924,4042
6041,MARIN,2019,59,2162,2038,4200
6041,MARIN,2019,60,2072,1788,3860
6041,MARIN,2019,61,2092,1808,3900
6041,MARIN,2019,62,2034,1707,3741
6041,MARIN,2019,63,2029,1811,3840
6041,MARIN,2019,64,2072,1757,3829
6041,MARIN,2019,65,2090,1809,3899
6041,MARIN,2019,66,2133,1813,3946
6041,MARIN,2019,67,2022,1763,3785
6041,MARIN,2019,68,1953,1691,3644
6041,MARIN,2019,69,2054,1726,3780
6041,MARIN,2019,70,1954,1673,3627
6041,MARIN,2019,71,2002,1736,3738
6041,MARIN,2019,72,2035,1722,3757
6041,MARIN,2019,73,1762,1422,3184
6041,MARIN,2019,74,1556,1384,2940
6041,MARIN,2019,75,1473,1357,2830
6041,MARIN,2019,76,1496,1276,2772
6041,MARIN,2019,77,1234,1097,2331
6041,MARIN,2019,78,1054,887,1941
6041,MARIN,2019,79,1030,761,1791
6041,MARIN,2019,80,903,790,1693
6041,MARIN,2019,81,852,724,1576
6041,MARIN,2019,82,788,577,1365
6041,MARIN,2019,83,675,578,1253
6041,MARIN,2019,84,623,538,1161
6041,MARIN,2019,85,651,439,1090
6041,MARIN,2019,86,583,459,1042
6041,MARIN,2019,87,535,374,909
6041,MARIN,2019,88,564,368,932
6041,MARIN,2019,89,518,300,818
6041,MARIN,2019,90,444,291,735
6041,MARIN,2019,91,383,215,598
6041,MARIN,2019,92,294,144,438
6041,MARIN,2019,93,259,130,389
6041,MARIN,2019,94,193,92,285
6041,MARIN,2019,95,186,63,249
6041,MARIN,2019,96,118,45,163
6041,MARIN,2019,97,92,33,125
6041,MARIN,2019,98,55,36,91
6041,MARIN,2019,99,44,16,60
6041,MARIN,2019,100,70,21,91
6043,MARIPOSA,2017,0,91,69,160
6043,MARIPOSA,2017,1,77,79,156
6043,MARIPOSA,2017,2,70,72,142
6043,MARIPOSA,2017,3,63,100,163
6043,MARIPOSA,2017,4,75,78,153
6043,MARIPOSA,2017,5,71,85,156
6043,MARIPOSA,2017,6,68,83,151
6043,MARIPOSA,2017,7,87,83,170
6043,MARIPOSA,2017,8,71,75,146
6043,MARIPOSA,2017,9,71,86,157
6043,MARIPOSA,2017,10,74,70,144
6043,MARIPOSA,2017,11,72,76,148
6043,MARIPOSA,2017,12,99,82,181
6043,MARIPOSA,2017,13,78,78,156
6043,MARIPOSA,2017,14,78,80,158
6043,MARIPOSA,2017,15,83,91,174
6043,MARIPOSA,2017,16,67,90,157
6043,MARIPOSA,2017,17,92,99,191
6043,MARIPOSA,2017,18,103,82,185
6043,MARIPOSA,2017,19,80,110,190
6043,MARIPOSA,2017,20,112,118,230
6043,MARIPOSA,2017,21,135,100,235
6043,MARIPOSA,2017,22,120,107,227
6043,MARIPOSA,2017,23,118,125,243
6043,MARIPOSA,2017,24,108,129,237
6043,MARIPOSA,2017,25,96,115,211
6043,MARIPOSA,2017,26,93,110,203
6043,MARIPOSA,2017,27,75,85,160
6043,MARIPOSA,2017,28,62,87,149
6043,MARIPOSA,2017,29,72,82,154
6043,MARIPOSA,2017,30,62,88,150
6043,MARIPOSA,2017,31,75,102,177
6043,MARIPOSA,2017,32,92,75,167
6043,MARIPOSA,2017,33,75,69,144
6043,MARIPOSA,2017,34,72,92,164
6043,MARIPOSA,2017,35,84,86,170
6043,MARIPOSA,2017,36,69,80,149
6043,MARIPOSA,2017,37,70,73,143
6043,MARIPOSA,2017,38,85,95,180
6043,MARIPOSA,2017,39,79,81,160
6043,MARIPOSA,2017,40,83,68,151
6043,MARIPOSA,2017,41,66,63,129
6043,MARIPOSA,2017,42,73,75,148
6043,MARIPOSA,2017,43,70,89,159
6043,MARIPOSA,2017,44,78,99,177
6043,MARIPOSA,2017,45,93,90,183
6043,MARIPOSA,2017,46,79,84,163
6043,MARIPOSA,2017,47,94,109,203
6043,MARIPOSA,2017,48,79,95,174
6043,MARIPOSA,2017,49,107,106,213
6043,MARIPOSA,2017,50,98,93,191
6043,MARIPOSA,2017,51,115,103,218
6043,MARIPOSA,2017,52,119,112,231
6043,MARIPOSA,2017,53,116,135,251
6043,MARIPOSA,2017,54,119,150,269
6043,MARIPOSA,2017,55,169,141,310
6043,MARIPOSA,2017,56,145,146,291
6043,MARIPOSA,2017,57,183,162,345
6043,MARIPOSA,2017,58,169,191,360
6043,MARIPOSA,2017,59,189,154,343
6043,MARIPOSA,2017,60,169,161,330
6043,MARIPOSA,2017,61,156,164,320
6043,MARIPOSA,2017,62,183,169,352
6043,MARIPOSA,2017,63,183,158,341
6043,MARIPOSA,2017,64,153,156,309
6043,MARIPOSA,2017,65,160,123,283
6043,MARIPOSA,2017,66,178,149,327
6043,MARIPOSA,2017,67,155,156,311
6043,MARIPOSA,2017,68,129,172,301
6043,MARIPOSA,2017,69,156,172,328
6043,MARIPOSA,2017,70,146,157,303
6043,MARIPOSA,2017,71,98,133,231
6043,MARIPOSA,2017,72,115,134,249
6043,MARIPOSA,2017,73,130,116,246
6043,MARIPOSA,2017,74,142,109,251
6043,MARIPOSA,2017,75,110,110,220
6043,MARIPOSA,2017,76,98,112,210
6043,MARIPOSA,2017,77,95,82,177
6043,MARIPOSA,2017,78,93,99,192
6043,MARIPOSA,2017,79,81,75,156
6043,MARIPOSA,2017,80,59,69,128
6043,MARIPOSA,2017,81,74,66,140
6043,MARIPOSA,2017,82,51,65,116
6043,MARIPOSA,2017,83,62,59,121
6043,MARIPOSA,2017,84,59,40,99
6043,MARIPOSA,2017,85,63,44,107
6043,MARIPOSA,2017,86,53,39,92
6043,MARIPOSA,2017,87,27,35,62
6043,MARIPOSA,2017,88,43,24,67
6043,MARIPOSA,2017,89,29,36,65
6043,MARIPOSA,2017,90,32,20,52
6043,MARIPOSA,2017,91,21,10,31
6043,MARIPOSA,2017,92,31,14,45
6043,MARIPOSA,2017,93,13,4,17
6043,MARIPOSA,2017,94,19,8,27
6043,MARIPOSA,2017,95,9,9,18
6043,MARIPOSA,2017,96,10,3,13
6043,MARIPOSA,2017,97,6,3,9
6043,MARIPOSA,2017,98,2,3,5
6043,MARIPOSA,2017,99,5,1,6
6043,MARIPOSA,2017,100,1,0,1
6043,MARIPOSA,2018,0,75,80,155
6043,MARIPOSA,2018,1,90,67,157
6043,MARIPOSA,2018,2,77,79,156
6043,MARIPOSA,2018,3,70,72,142
6043,MARIPOSA,2018,4,63,101,164
6043,MARIPOSA,2018,5,76,77,153
6043,MARIPOSA,2018,6,71,87,158
6043,MARIPOSA,2018,7,68,85,153
6043,MARIPOSA,2018,8,87,87,174
6043,MARIPOSA,2018,9,71,73,144
6043,MARIPOSA,2018,10,72,87,159
6043,MARIPOSA,2018,11,74,70,144
6043,MARIPOSA,2018,12,72,76,148
6043,MARIPOSA,2018,13,100,82,182
6043,MARIPOSA,2018,14,77,78,155
6043,MARIPOSA,2018,15,82,81,163
6043,MARIPOSA,2018,16,83,92,175
6043,MARIPOSA,2018,17,65,86,151
6043,MARIPOSA,2018,18,92,98,190
6043,MARIPOSA,2018,19,102,87,189
6043,MARIPOSA,2018,20,87,121,208
6043,MARIPOSA,2018,21,117,107,224
6043,MARIPOSA,2018,22,131,112,243
6043,MARIPOSA,2018,23,116,109,225
6043,MARIPOSA,2018,24,119,126,245
6043,MARIPOSA,2018,25,106,123,229
6043,MARIPOSA,2018,26,100,116,216
6043,MARIPOSA,2018,27,85,115,200
6043,MARIPOSA,2018,28,79,79,158
6043,MARIPOSA,2018,29,62,90,152
6043,MARIPOSA,2018,30,72,71,143
6043,MARIPOSA,2018,31,59,94,153
6043,MARIPOSA,2018,32,79,96,175
6043,MARIPOSA,2018,33,88,81,169
6043,MARIPOSA,2018,34,74,69,143
6043,MARIPOSA,2018,35,70,84,154
6043,MARIPOSA,2018,36,83,88,171
6043,MARIPOSA,2018,37,71,75,146
6043,MARIPOSA,2018,38,72,78,150
6043,MARIPOSA,2018,39,82,92,174
6043,MARIPOSA,2018,40,80,75,155
6043,MARIPOSA,2018,41,82,75,157
6043,MARIPOSA,2018,42,64,62,126
6043,MARIPOSA,2018,43,73,76,149
6043,MARIPOSA,2018,44,72,85,157
6043,MARIPOSA,2018,45,83,106,189
6043,MARIPOSA,2018,46,85,84,169
6043,MARIPOSA,2018,47,88,88,176
6043,MARIPOSA,2018,48,91,110,201
6043,MARIPOSA,2018,49,79,95,174
6043,MARIPOSA,2018,50,109,105,214
6043,MARIPOSA,2018,51,97,91,188
6043,MARIPOSA,2018,52,112,103,215
6043,MARIPOSA,2018,53,116,114,230
6043,MARIPOSA,2018,54,118,136,254
6043,MARIPOSA,2018,55,117,140,257
6043,MARIPOSA,2018,56,170,145,315
6043,MARIPOSA,2018,57,146,149,295
6043,MARIPOSA,2018,58,186,166,352
6043,MARIPOSA,2018,59,172,188,360
6043,MARIPOSA,2018,60,188,149,337
6043,MARIPOSA,2018,61,174,163,337
6043,MARIPOSA,2018,62,158,164,322
6043,MARIPOSA,2018,63,188,169,357
6043,MARIPOSA,2018,64,186,156,342
6043,MARIPOSA,2018,65,151,151,302
6043,MARIPOSA,2018,66,158,126,284
6043,MARIPOSA,2018,67,178,144,322
6043,MARIPOSA,2018,68,151,155,306
6043,MARIPOSA,2018,69,128,172,300
6043,MARIPOSA,2018,70,157,170,327
6043,MARIPOSA,2018,71,143,153,296
6043,MARIPOSA,2018,72,96,128,224
6043,MARIPOSA,2018,73,112,133,245
6043,MARIPOSA,2018,74,129,115,244
6043,MARIPOSA,2018,75,139,106,245
6043,MARIPOSA,2018,76,110,108,218
6043,MARIPOSA,2018,77,97,108,205
6043,MARIPOSA,2018,78,89,79,168
6043,MARIPOSA,2018,79,92,93,185
6043,MARIPOSA,2018,80,80,73,153
6043,MARIPOSA,2018,81,57,64,121
6043,MARIPOSA,2018,82,69,62,131
6043,MARIPOSA,2018,83,47,63,110
6043,MARIPOSA,2018,84,61,53,114
6043,MARIPOSA,2018,85,60,45,105
6043,MARIPOSA,2018,86,57,34,91
6043,MARIPOSA,2018,87,48,37,85
6043,MARIPOSA,2018,88,26,32,58
6043,MARIPOSA,2018,89,41,19,60
6043,MARIPOSA,2018,90,25,32,57
6043,MARIPOSA,2018,91,30,18,48
6043,MARIPOSA,2018,92,21,10,31
6043,MARIPOSA,2018,93,26,12,38
6043,MARIPOSA,2018,94,12,4,16
6043,MARIPOSA,2018,95,15,4,19
6043,MARIPOSA,2018,96,7,6,13
6043,MARIPOSA,2018,97,6,2,8
6043,MARIPOSA,2018,98,4,2,6
6043,MARIPOSA,2018,99,1,2,3
6043,MARIPOSA,2018,100,4,0,4
6043,MARIPOSA,2019,0,84,75,159
6043,MARIPOSA,2019,1,73,79,152
6043,MARIPOSA,2019,2,90,67,157
6043,MARIPOSA,2019,3,77,79,156
6043,MARIPOSA,2019,4,70,73,143
6043,MARIPOSA,2019,5,64,99,163
6043,MARIPOSA,2019,6,75,78,153
6043,MARIPOSA,2019,7,71,89,160
6043,MARIPOSA,2019,8,70,88,158
6043,MARIPOSA,2019,9,87,85,172
6043,MARIPOSA,2019,10,73,74,147
6043,MARIPOSA,2019,11,72,87,159
6043,MARIPOSA,2019,12,74,70,144
6043,MARIPOSA,2019,13,73,76,149
6043,MARIPOSA,2019,14,99,82,181
6043,MARIPOSA,2019,15,80,79,159
6043,MARIPOSA,2019,16,82,81,163
6043,MARIPOSA,2019,17,83,90,173
6043,MARIPOSA,2019,18,65,87,152
6043,MARIPOSA,2019,19,89,101,190
6043,MARIPOSA,2019,20,109,98,207
6043,MARIPOSA,2019,21,92,110,202
6043,MARIPOSA,2019,22,113,118,231
6043,MARIPOSA,2019,23,127,114,241
6043,MARIPOSA,2019,24,119,111,230
6043,MARIPOSA,2019,25,117,120,237
6043,MARIPOSA,2019,26,110,123,233
6043,MARIPOSA,2019,27,92,121,213
6043,MARIPOSA,2019,28,89,108,197
6043,MARIPOSA,2019,29,79,82,161
6043,MARIPOSA,2019,30,62,81,143
6043,MARIPOSA,2019,31,69,77,146
6043,MARIPOSA,2019,32,63,88,151
6043,MARIPOSA,2019,33,75,103,178
6043,MARIPOSA,2019,34,87,80,167
6043,MARIPOSA,2019,35,73,60,133
6043,MARIPOSA,2019,36,70,86,156
6043,MARIPOSA,2019,37,85,84,169
6043,MARIPOSA,2019,38,73,79,152
6043,MARIPOSA,2019,39,69,75,144
6043,MARIPOSA,2019,40,83,86,169
6043,MARIPOSA,2019,41,78,83,161
6043,MARIPOSA,2019,42,80,74,154
6043,MARIPOSA,2019,43,64,64,128
6043,MARIPOSA,2019,44,74,72,146
6043,MARIPOSA,2019,45,77,92,169
6043,MARIPOSA,2019,46,75,103,178
6043,MARIPOSA,2019,47,92,89,181
6043,MARIPOSA,2019,48,86,90,176
6043,MARIPOSA,2019,49,88,110,198
6043,MARIPOSA,2019,50,84,92,176
6043,MARIPOSA,2019,51,109,103,212
6043,MARIPOSA,2019,52,95,91,186
6043,MARIPOSA,2019,53,110,105,215
6043,MARIPOSA,2019,54,117,114,231
6043,MARIPOSA,2019,55,115,126,241
6043,MARIPOSA,2019,56,121,146,267
6043,MARIPOSA,2019,57,176,144,320
6043,MARIPOSA,2019,58,147,150,297
6043,MARIPOSA,2019,59,190,163,353
6043,MARIPOSA,2019,60,168,187,355
6043,MARIPOSA,2019,61,190,152,342
6043,MARIPOSA,2019,62,173,166,339
6043,MARIPOSA,2019,63,161,164,325
6043,MARIPOSA,2019,64,193,167,360
6043,MARIPOSA,2019,65,183,150,333
6043,MARIPOSA,2019,66,150,153,303
6043,MARIPOSA,2019,67,159,122,281
6043,MARIPOSA,2019,68,175,140,315
6043,MARIPOSA,2019,69,151,153,304
6043,MARIPOSA,2019,70,129,169,298
6043,MARIPOSA,2019,71,152,170,322
6043,MARIPOSA,2019,72,141,146,287
6043,MARIPOSA,2019,73,95,125,220
6043,MARIPOSA,2019,74,112,132,244
6043,MARIPOSA,2019,75,128,113,241
6043,MARIPOSA,2019,76,136,102,238
6043,MARIPOSA,2019,77,110,102,212
6043,MARIPOSA,2019,78,96,106,202
6043,MARIPOSA,2019,79,86,75,161
6043,MARIPOSA,2019,80,88,92,180
6043,MARIPOSA,2019,81,78,71,149
6043,MARIPOSA,2019,82,55,60,115
6043,MARIPOSA,2019,83,66,59,125
6043,MARIPOSA,2019,84,47,56,103
6043,MARIPOSA,2019,85,63,52,115
6043,MARIPOSA,2019,86,54,34,88
6043,MARIPOSA,2019,87,52,34,86
6043,MARIPOSA,2019,88,47,36,83
6043,MARIPOSA,2019,89,24,31,55
6043,MARIPOSA,2019,90,37,16,53
6043,MARIPOSA,2019,91,23,25,48
6043,MARIPOSA,2019,92,27,16,43
6043,MARIPOSA,2019,93,18,9,27
6043,MARIPOSA,2019,94,25,12,37
6043,MARIPOSA,2019,95,9,3,12
6043,MARIPOSA,2019,96,11,2,13
6043,MARIPOSA,2019,97,7,3,10
6043,MARIPOSA,2019,98,5,1,6
6043,MARIPOSA,2019,99,1,1,2
6043,MARIPOSA,2019,100,3,2,5
6045,MENDOCINO,2017,0,497,502,999
6045,MENDOCINO,2017,1,517,485,1002
6045,MENDOCINO,2017,2,491,523,1014
6045,MENDOCINO,2017,3,505,541,1046
6045,MENDOCINO,2017,4,530,521,1051
6045,MENDOCINO,2017,5,517,596,1113
6045,MENDOCINO,2017,6,487,532,1019
6045,MENDOCINO,2017,7,515,583,1098
6045,MENDOCINO,2017,8,521,558,1079
6045,MENDOCINO,2017,9,522,556,1078
6045,MENDOCINO,2017,10,505,593,1098
6045,MENDOCINO,2017,11,530,591,1121
6045,MENDOCINO,2017,12,518,534,1052
6045,MENDOCINO,2017,13,535,576,1111
6045,MENDOCINO,2017,14,509,504,1013
6045,MENDOCINO,2017,15,551,510,1061
6045,MENDOCINO,2017,16,508,552,1060
6045,MENDOCINO,2017,17,520,581,1101
6045,MENDOCINO,2017,18,472,579,1051
6045,MENDOCINO,2017,19,599,545,1144
6045,MENDOCINO,2017,20,534,511,1045
6045,MENDOCINO,2017,21,488,554,1042
6045,MENDOCINO,2017,22,510,569,1079
6045,MENDOCINO,2017,23,499,607,1106
6045,MENDOCINO,2017,24,487,559,1046
6045,MENDOCINO,2017,25,453,554,1007
6045,MENDOCINO,2017,26,476,525,1001
6045,MENDOCINO,2017,27,472,527,999
6045,MENDOCINO,2017,28,412,526,938
6045,MENDOCINO,2017,29,458,533,991
6045,MENDOCINO,2017,30,478,581,1059
6045,MENDOCINO,2017,31,504,582,1086
6045,MENDOCINO,2017,32,600,580,1180
6045,MENDOCINO,2017,33,539,571,1110
6045,MENDOCINO,2017,34,540,560,1100
6045,MENDOCINO,2017,35,511,610,1121
6045,MENDOCINO,2017,36,541,525,1066
6045,MENDOCINO,2017,37,484,589,1073
6045,MENDOCINO,2017,38,516,493,1009
6045,MENDOCINO,2017,39,490,540,1030
6045,MENDOCINO,2017,40,495,531,1026
6045,MENDOCINO,2017,41,455,507,962
6045,MENDOCINO,2017,42,475,556,1031
6045,MENDOCINO,2017,43,477,544,1021
6045,MENDOCINO,2017,44,482,513,995
6045,MENDOCINO,2017,45,520,509,1029
6045,MENDOCINO,2017,46,531,562,1093
6045,MENDOCINO,2017,47,521,578,1099
6045,MENDOCINO,2017,48,523,563,1086
6045,MENDOCINO,2017,49,485,547,1032
6045,MENDOCINO,2017,50,452,498,950
6045,MENDOCINO,2017,51,492,479,971
6045,MENDOCINO,2017,52,480,520,1000
6045,MENDOCINO,2017,53,522,538,1060
6045,MENDOCINO,2017,54,555,552,1107
6045,MENDOCINO,2017,55,619,535,1154
6045,MENDOCINO,2017,56,630,553,1183
6045,MENDOCINO,2017,57,661,614,1275
6045,MENDOCINO,2017,58,583,604,1187
6045,MENDOCINO,2017,59,644,630,1274
6045,MENDOCINO,2017,60,669,608,1277
6045,MENDOCINO,2017,61,710,618,1328
6045,MENDOCINO,2017,62,698,624,1322
6045,MENDOCINO,2017,63,742,629,1371
6045,MENDOCINO,2017,64,716,651,1367
6045,MENDOCINO,2017,65,719,625,1344
6045,MENDOCINO,2017,66,760,636,1396
6045,MENDOCINO,2017,67,753,667,1420
6045,MENDOCINO,2017,68,711,626,1337
6045,MENDOCINO,2017,69,691,693,1384
6045,MENDOCINO,2017,70,719,643,1362
6045,MENDOCINO,2017,71,528,539,1067
6045,MENDOCINO,2017,72,470,500,970
6045,MENDOCINO,2017,73,457,403,860
6045,MENDOCINO,2017,74,423,396,819
6045,MENDOCINO,2017,75,430,356,786
6045,MENDOCINO,2017,76,315,308,623
6045,MENDOCINO,2017,77,284,271,555
6045,MENDOCINO,2017,78,283,223,506
6045,MENDOCINO,2017,79,237,220,457
6045,MENDOCINO,2017,80,216,212,428
6045,MENDOCINO,2017,81,219,185,404
6045,MENDOCINO,2017,82,199,156,355
6045,MENDOCINO,2017,83,182,133,315
6045,MENDOCINO,2017,84,166,124,290
6045,MENDOCINO,2017,85,165,126,291
6045,MENDOCINO,2017,86,176,117,293
6045,MENDOCINO,2017,87,152,102,254
6045,MENDOCINO,2017,88,143,79,222
6045,MENDOCINO,2017,89,130,57,187
6045,MENDOCINO,2017,90,108,70,178
6045,MENDOCINO,2017,91,103,51,154
6045,MENDOCINO,2017,92,83,32,115
6045,MENDOCINO,2017,93,79,17,96
6045,MENDOCINO,2017,94,52,29,81
6045,MENDOCINO,2017,95,38,17,55
6045,MENDOCINO,2017,96,37,2,39
6045,MENDOCINO,2017,97,21,5,26
6045,MENDOCINO,2017,98,12,4,16
6045,MENDOCINO,2017,99,16,3,19
6045,MENDOCINO,2017,100,23,3,26
6045,MENDOCINO,2018,0,470,529,999
6045,MENDOCINO,2018,1,501,497,998
6045,MENDOCINO,2018,2,508,490,998
6045,MENDOCINO,2018,3,497,525,1022
6045,MENDOCINO,2018,4,508,544,1052
6045,MENDOCINO,2018,5,529,524,1053
6045,MENDOCINO,2018,6,520,603,1123
6045,MENDOCINO,2018,7,484,537,1021
6045,MENDOCINO,2018,8,519,581,1100
6045,MENDOCINO,2018,9,529,560,1089
6045,MENDOCINO,2018,10,524,565,1089
6045,MENDOCINO,2018,11,500,591,1091
6045,MENDOCINO,2018,12,533,592,1125
6045,MENDOCINO,2018,13,514,528,1042
6045,MENDOCINO,2018,14,538,579,1117
6045,MENDOCINO,2018,15,512,499,1011
6045,MENDOCINO,2018,16,548,509,1057
6045,MENDOCINO,2018,17,530,589,1119
6045,MENDOCINO,2018,18,504,565,1069
6045,MENDOCINO,2018,19,491,603,1094
6045,MENDOCINO,2018,20,580,527,1107
6045,MENDOCINO,2018,21,528,497,1025
6045,MENDOCINO,2018,22,481,569,1050
6045,MENDOCINO,2018,23,516,561,1077
6045,MENDOCINO,2018,24,489,607,1096
6045,MENDOCINO,2018,25,483,550,1033
6045,MENDOCINO,2018,26,469,571,1040
6045,MENDOCINO,2018,27,481,537,1018
6045,MENDOCINO,2018,28,475,538,1013
6045,MENDOCINO,2018,29,425,554,979
6045,MENDOCINO,2018,30,470,530,1000
6045,MENDOCINO,2018,31,476,572,1048
6045,MENDOCINO,2018,32,505,580,1085
6045,MENDOCINO,2018,33,597,578,1175
6045,MENDOCINO,2018,34,535,572,1107
6045,MENDOCINO,2018,35,537,549,1086
6045,MENDOCINO,2018,36,513,614,1127
6045,MENDOCINO,2018,37,547,527,1074
6045,MENDOCINO,2018,38,479,588,1067
6045,MENDOCINO,2018,39,520,504,1024
6045,MENDOCINO,2018,40,490,542,1032
6045,MENDOCINO,2018,41,491,531,1022
6045,MENDOCINO,2018,42,453,507,960
6045,MENDOCINO,2018,43,480,568,1048
6045,MENDOCINO,2018,44,488,536,1024
6045,MENDOCINO,2018,45,491,515,1006
6045,MENDOCINO,2018,46,515,515,1030
6045,MENDOCINO,2018,47,525,550,1075
6045,MENDOCINO,2018,48,524,584,1108
6045,MENDOCINO,2018,49,519,560,1079
6045,MENDOCINO,2018,50,487,536,1023
6045,MENDOCINO,2018,51,454,499,953
6045,MENDOCINO,2018,52,492,475,967
6045,MENDOCINO,2018,53,481,517,998
6045,MENDOCINO,2018,54,519,532,1051
6045,MENDOCINO,2018,55,549,535,1084
6045,MENDOCINO,2018,56,619,543,1162
6045,MENDOCINO,2018,57,631,547,1178
6045,MENDOCINO,2018,58,659,601,1260
6045,MENDOCINO,2018,59,580,605,1185
6045,MENDOCINO,2018,60,634,617,1251
6045,MENDOCINO,2018,61,675,596,1271
6045,MENDOCINO,2018,62,709,614,1323
6045,MENDOCINO,2018,63,688,621,1309
6045,MENDOCINO,2018,64,740,613,1353
6045,MENDOCINO,2018,65,715,645,1360
6045,MENDOCINO,2018,66,722,615,1337
6045,MENDOCINO,2018,67,741,635,1376
6045,MENDOCINO,2018,68,744,646,1390
6045,MENDOCINO,2018,69,704,614,1318
6045,MENDOCINO,2018,70,684,681,1365
6045,MENDOCINO,2018,71,705,632,1337
6045,MENDOCINO,2018,72,521,527,1048
6045,MENDOCINO,2018,73,461,483,944
6045,MENDOCINO,2018,74,447,398,845
6045,MENDOCINO,2018,75,420,387,807
6045,MENDOCINO,2018,76,405,344,749
6045,MENDOCINO,2018,77,309,292,601
6045,MENDOCINO,2018,78,276,261,537
6045,MENDOCINO,2018,79,270,210,480
6045,MENDOCINO,2018,80,234,217,451
6045,MENDOCINO,2018,81,208,192,400
6045,MENDOCINO,2018,82,207,165,372
6045,MENDOCINO,2018,83,197,153,350
6045,MENDOCINO,2018,84,173,121,294
6045,MENDOCINO,2018,85,170,119,289
6045,MENDOCINO,2018,86,141,111,252
6045,MENDOCINO,2018,87,175,112,287
6045,MENDOCINO,2018,88,134,90,224
6045,MENDOCINO,2018,89,126,72,198
6045,MENDOCINO,2018,90,117,50,167
6045,MENDOCINO,2018,91,86,53,139
6045,MENDOCINO,2018,92,83,37,120
6045,MENDOCINO,2018,93,76,22,98
6045,MENDOCINO,2018,94,69,14,83
6045,MENDOCINO,2018,95,42,21,63
6045,MENDOCINO,2018,96,39,11,50
6045,MENDOCINO,2018,97,24,2,26
6045,MENDOCINO,2018,98,17,2,19
6045,MENDOCINO,2018,99,9,2,11
6045,MENDOCINO,2018,100,22,3,25
6045,MENDOCINO,2019,0,509,490,999
6045,MENDOCINO,2019,1,472,527,999
6045,MENDOCINO,2019,2,492,497,989
6045,MENDOCINO,2019,3,516,493,1009
6045,MENDOCINO,2019,4,502,529,1031
6045,MENDOCINO,2019,5,508,546,1054
6045,MENDOCINO,2019,6,531,534,1065
6045,MENDOCINO,2019,7,517,608,1125
6045,MENDOCINO,2019,8,492,535,1027
6045,MENDOCINO,2019,9,525,583,1108
6045,MENDOCINO,2019,10,530,567,1097
6045,MENDOCINO,2019,11,522,563,1085
6045,MENDOCINO,2019,12,503,590,1093
6045,MENDOCINO,2019,13,527,586,1113
6045,MENDOCINO,2019,14,516,531,1047
6045,MENDOCINO,2019,15,539,575,1114
6045,MENDOCINO,2019,16,507,502,1009
6045,MENDOCINO,2019,17,572,547,1119
6045,MENDOCINO,2019,18,516,573,1089
6045,MENDOCINO,2019,19,523,589,1112
6045,MENDOCINO,2019,20,472,580,1052
6045,MENDOCINO,2019,21,574,514,1088
6045,MENDOCINO,2019,22,521,511,1032
6045,MENDOCINO,2019,23,490,561,1051
6045,MENDOCINO,2019,24,505,559,1064
6045,MENDOCINO,2019,25,486,601,1087
6045,MENDOCINO,2019,26,499,566,1065
6045,MENDOCINO,2019,27,475,585,1060
6045,MENDOCINO,2019,28,485,545,1030
6045,MENDOCINO,2019,29,489,557,1046
6045,MENDOCINO,2019,30,443,552,995
6045,MENDOCINO,2019,31,468,521,989
6045,MENDOCINO,2019,32,478,569,1047
6045,MENDOCINO,2019,33,501,577,1078
6045,MENDOCINO,2019,34,592,578,1170
6045,MENDOCINO,2019,35,532,566,1098
6045,MENDOCINO,2019,36,538,551,1089
6045,MENDOCINO,2019,37,518,616,1134
6045,MENDOCINO,2019,38,543,527,1070
6045,MENDOCINO,2019,39,483,598,1081
6045,MENDOCINO,2019,40,522,505,1027
6045,MENDOCINO,2019,41,487,543,1030
6045,MENDOCINO,2019,42,497,534,1031
6045,MENDOCINO,2019,43,459,515,974
6045,MENDOCINO,2019,44,485,557,1042
6045,MENDOCINO,2019,45,496,540,1036
6045,MENDOCINO,2019,46,489,520,1009
6045,MENDOCINO,2019,47,509,507,1016
6045,MENDOCINO,2019,48,529,553,1082
6045,MENDOCINO,2019,49,522,576,1098
6045,MENDOCINO,2019,50,521,549,1070
6045,MENDOCINO,2019,51,483,537,1020
6045,MENDOCINO,2019,52,453,503,956
6045,MENDOCINO,2019,53,492,470,962
6045,MENDOCINO,2019,54,480,514,994
6045,MENDOCINO,2019,55,511,523,1034
6045,MENDOCINO,2019,56,545,547,1092
6045,MENDOCINO,2019,57,617,534,1151
6045,MENDOCINO,2019,58,626,537,1163
6045,MENDOCINO,2019,59,657,599,1256
6045,MENDOCINO,2019,60,575,602,1177
6045,MENDOCINO,2019,61,633,598,1231
6045,MENDOCINO,2019,62,672,598,1270
6045,MENDOCINO,2019,63,706,616,1322
6045,MENDOCINO,2019,64,686,609,1295
6045,MENDOCINO,2019,65,737,611,1348
6045,MENDOCINO,2019,66,712,634,1346
6045,MENDOCINO,2019,67,705,609,1314
6045,MENDOCINO,2019,68,736,620,1356
6045,MENDOCINO,2019,69,735,636,1371
6045,MENDOCINO,2019,70,697,607,1304
6045,MENDOCINO,2019,71,665,663,1328
6045,MENDOCINO,2019,72,688,607,1295
6045,MENDOCINO,2019,73,512,512,1024
6045,MENDOCINO,2019,74,450,470,920
6045,MENDOCINO,2019,75,441,394,835
6045,MENDOCINO,2019,76,407,374,781
6045,MENDOCINO,2019,77,394,331,725
6045,MENDOCINO,2019,78,297,279,576
6045,MENDOCINO,2019,79,265,250,515
6045,MENDOCINO,2019,80,270,207,477
6045,MENDOCINO,2019,81,216,213,429
6045,MENDOCINO,2019,82,196,177,373
6045,MENDOCINO,2019,83,205,160,365
6045,MENDOCINO,2019,84,186,145,331
6045,MENDOCINO,2019,85,175,115,290
6045,MENDOCINO,2019,86,154,108,262
6045,MENDOCINO,2019,87,141,103,244
6045,MENDOCINO,2019,88,159,103,262
6045,MENDOCINO,2019,89,112,78,190
6045,MENDOCINO,2019,90,116,63,179
6045,MENDOCINO,2019,91,100,40,140
6045,MENDOCINO,2019,92,68,42,110
6045,MENDOCINO,2019,93,73,31,104
6045,MENDOCINO,2019,94,68,17,85
6045,MENDOCINO,2019,95,52,10,62
6045,MENDOCINO,2019,96,36,11,47
6045,MENDOCINO,2019,97,27,7,34
6045,MENDOCINO,2019,98,16,0,16
6045,MENDOCINO,2019,99,10,2,12
6045,MENDOCINO,2019,100,18,4,22
6047,MERCED,2017,0,1930,2169,4099
6047,MERCED,2017,1,1981,2084,4065
6047,MERCED,2017,2,1998,2112,4110
6047,MERCED,2017,3,2061,2205,4266
6047,MERCED,2017,4,2092,2136,4228
6047,MERCED,2017,5,2131,2211,4342
6047,MERCED,2017,6,2080,2290,4370
6047,MERCED,2017,7,2130,2254,4384
6047,MERCED,2017,8,2205,2243,4448
6047,MERCED,2017,9,2253,2359,4612
6047,MERCED,2017,10,2377,2435,4812
6047,MERCED,2017,11,2271,2445,4716
6047,MERCED,2017,12,2257,2345,4602
6047,MERCED,2017,13,2247,2346,4593
6047,MERCED,2017,14,2208,2336,4544
6047,MERCED,2017,15,2193,2303,4496
6047,MERCED,2017,16,2293,2387,4680
6047,MERCED,2017,17,2202,2340,4542
6047,MERCED,2017,18,2691,2842,5533
6047,MERCED,2017,19,2620,2763,5383
6047,MERCED,2017,20,2486,2771,5257
6047,MERCED,2017,21,2553,2826,5379
6047,MERCED,2017,22,2253,2605,4858
6047,MERCED,2017,23,2387,2418,4805
6047,MERCED,2017,24,2177,2371,4548
6047,MERCED,2017,25,2071,2210,4281
6047,MERCED,2017,26,1887,2216,4103
6047,MERCED,2017,27,1724,1940,3664
6047,MERCED,2017,28,1672,1705,3377
6047,MERCED,2017,29,1591,1837,3428
6047,MERCED,2017,30,1621,1835,3456
6047,MERCED,2017,31,1660,1898,3558
6047,MERCED,2017,32,1787,1985,3772
6047,MERCED,2017,33,1813,1910,3723
6047,MERCED,2017,34,1805,1941,3746
6047,MERCED,2017,35,1787,1895,3682
6047,MERCED,2017,36,1850,1877,3727
6047,MERCED,2017,37,1768,1939,3707
6047,MERCED,2017,38,1747,1727,3474
6047,MERCED,2017,39,1692,1661,3353
6047,MERCED,2017,40,1652,1650,3302
6047,MERCED,2017,41,1611,1617,3228
6047,MERCED,2017,42,1643,1685,3328
6047,MERCED,2017,43,1601,1566,3167
6047,MERCED,2017,44,1657,1599,3256
6047,MERCED,2017,45,1533,1614,3147
6047,MERCED,2017,46,1600,1592,3192
6047,MERCED,2017,47,1654,1523,3177
6047,MERCED,2017,48,1527,1572,3099
6047,MERCED,2017,49,1478,1597,3075
6047,MERCED,2017,50,1443,1569,3012
6047,MERCED,2017,51,1551,1587,3138
6047,MERCED,2017,52,1591,1569,3160
6047,MERCED,2017,53,1584,1597,3181
6047,MERCED,2017,54,1503,1535,3038
6047,MERCED,2017,55,1653,1498,3151
6047,MERCED,2017,56,1494,1445,2939
6047,MERCED,2017,57,1467,1452,2919
6047,MERCED,2017,58,1408,1408,2816
6047,MERCED,2017,59,1377,1346,2723
6047,MERCED,2017,60,1401,1328,2729
6047,MERCED,2017,61,1364,1293,2657
6047,MERCED,2017,62,1286,1290,2576
6047,MERCED,2017,63,1256,1168,2424
6047,MERCED,2017,64,1188,1093,2281
6047,MERCED,2017,65,1115,1038,2153
6047,MERCED,2017,66,1100,1003,2103
6047,MERCED,2017,67,1046,1008,2054
6047,MERCED,2017,68,948,986,1934
6047,MERCED,2017,69,996,932,1928
6047,MERCED,2017,70,1007,866,1873
6047,MERCED,2017,71,846,750,1596
6047,MERCED,2017,72,818,733,1551
6047,MERCED,2017,73,773,640,1413
6047,MERCED,2017,74,696,620,1316
6047,MERCED,2017,75,617,575,1192
6047,MERCED,2017,76,639,529,1168
6047,MERCED,2017,77,573,485,1058
6047,MERCED,2017,78,513,419,932
6047,MERCED,2017,79,513,395,908
6047,MERCED,2017,80,473,357,830
6047,MERCED,2017,81,449,334,783
6047,MERCED,2017,82,419,296,715
6047,MERCED,2017,83,401,277,678
6047,MERCED,2017,84,333,244,577
6047,MERCED,2017,85,370,275,645
6047,MERCED,2017,86,320,196,516
6047,MERCED,2017,87,300,175,475
6047,MERCED,2017,88,252,141,393
6047,MERCED,2017,89,256,132,388
6047,MERCED,2017,90,192,134,326
6047,MERCED,2017,91,198,65,263
6047,MERCED,2017,92,135,49,184
6047,MERCED,2017,93,86,66,152
6047,MERCED,2017,94,85,17,102
6047,MERCED,2017,95,76,38,114
6047,MERCED,2017,96,43,14,57
6047,MERCED,2017,97,29,14,43
6047,MERCED,2017,98,19,1,20
6047,MERCED,2017,99,13,8,21
6047,MERCED,2017,100,22,5,27
6047,MERCED,2018,0,1881,2149,4030
6047,MERCED,2018,1,1921,2161,4082
6047,MERCED,2018,2,2001,2100,4101
6047,MERCED,2018,3,2029,2137,4166
6047,MERCED,2018,4,2063,2212,4275
6047,MERCED,2018,5,2109,2156,4265
6047,MERCED,2018,6,2154,2230,4384
6047,MERCED,2018,7,2111,2298,4409
6047,MERCED,2018,8,2167,2290,4457
6047,MERCED,2018,9,2216,2253,4469
6047,MERCED,2018,10,2266,2380,4646
6047,MERCED,2018,11,2389,2451,4840
6047,MERCED,2018,12,2296,2460,4756
6047,MERCED,2018,13,2271,2365,4636
6047,MERCED,2018,14,2255,2351,4606
6047,MERCED,2018,15,2225,2352,4577
6047,MERCED,2018,16,2214,2325,4539
6047,MERCED,2018,17,2287,2394,4681
6047,MERCED,2018,18,2709,2927,5636
6047,MERCED,2018,19,2661,2790,5451
6047,MERCED,2018,20,2544,2743,5287
6047,MERCED,2018,21,2386,2648,5034
6047,MERCED,2018,22,2474,2731,5205
6047,MERCED,2018,23,2203,2502,4705
6047,MERCED,2018,24,2300,2337,4637
6047,MERCED,2018,25,2117,2340,4457
6047,MERCED,2018,26,2067,2208,4275
6047,MERCED,2018,27,1877,2218,4095
6047,MERCED,2018,28,1747,1945,3692
6047,MERCED,2018,29,1684,1734,3418
6047,MERCED,2018,30,1613,1895,3508
6047,MERCED,2018,31,1620,1811,3431
6047,MERCED,2018,32,1669,1908,3577
6047,MERCED,2018,33,1834,1996,3830
6047,MERCED,2018,34,1817,1922,3739
6047,MERCED,2018,35,1806,1906,3712
6047,MERCED,2018,36,1801,1874,3675
6047,MERCED,2018,37,1865,1917,3782
6047,MERCED,2018,38,1770,1937,3707
6047,MERCED,2018,39,1767,1747,3514
6047,MERCED,2018,40,1688,1638,3326
6047,MERCED,2018,41,1647,1634,3281
6047,MERCED,2018,42,1607,1635,3242
6047,MERCED,2018,43,1641,1686,3327
6047,MERCED,2018,44,1600,1536,3136
6047,MERCED,2018,45,1661,1614,3275
6047,MERCED,2018,46,1536,1615,3151
6047,MERCED,2018,47,1594,1583,3177
6047,MERCED,2018,48,1654,1548,3202
6047,MERCED,2018,49,1524,1574,3098
6047,MERCED,2018,50,1501,1584,3085
6047,MERCED,2018,51,1420,1553,2973
6047,MERCED,2018,52,1547,1578,3125
6047,MERCED,2018,53,1571,1549,3120
6047,MERCED,2018,54,1580,1582,3162
6047,MERCED,2018,55,1488,1534,3022
6047,MERCED,2018,56,1656,1476,3132
6047,MERCED,2018,57,1474,1424,2898
6047,MERCED,2018,58,1458,1446,2904
6047,MERCED,2018,59,1393,1385,2778
6047,MERCED,2018,60,1365,1332,2697
6047,MERCED,2018,61,1388,1314,2702
6047,MERCED,2018,62,1354,1271,2625
6047,MERCED,2018,63,1279,1268,2547
6047,MERCED,2018,64,1246,1149,2395
6047,MERCED,2018,65,1171,1071,2242
6047,MERCED,2018,66,1109,1023,2132
6047,MERCED,2018,67,1088,985,2073
6047,MERCED,2018,68,1031,996,2027
6047,MERCED,2018,69,934,965,1899
6047,MERCED,2018,70,991,917,1908
6047,MERCED,2018,71,986,830,1816
6047,MERCED,2018,72,831,737,1568
6047,MERCED,2018,73,799,701,1500
6047,MERCED,2018,74,748,628,1376
6047,MERCED,2018,75,695,615,1310
6047,MERCED,2018,76,595,542,1137
6047,MERCED,2018,77,627,496,1123
6047,MERCED,2018,78,567,466,1033
6047,MERCED,2018,79,496,403,899
6047,MERCED,2018,80,510,376,886
6047,MERCED,2018,81,442,325,767
6047,MERCED,2018,82,420,305,725
6047,MERCED,2018,83,387,289,676
6047,MERCED,2018,84,380,249,629
6047,MERCED,2018,85,336,233,569
6047,MERCED,2018,86,345,259,604
6047,MERCED,2018,87,293,175,468
6047,MERCED,2018,88,266,146,412
6047,MERCED,2018,89,226,131,357
6047,MERCED,2018,90,222,117,339
6047,MERCED,2018,91,176,108,284
6047,MERCED,2018,92,162,55,217
6047,MERCED,2018,93,112,43,155
6047,MERCED,2018,94,74,51,125
6047,MERCED,2018,95,69,15,84
6047,MERCED,2018,96,67,25,92
6047,MERCED,2018,97,38,10,48
6047,MERCED,2018,98,20,8,28
6047,MERCED,2018,99,13,1,14
6047,MERCED,2018,100,24,9,33
6047,MERCED,2019,0,1928,2225,4153
6047,MERCED,2019,1,1877,2142,4019
6047,MERCED,2019,2,1937,2174,4111
6047,MERCED,2019,3,2045,2120,4165
6047,MERCED,2019,4,2034,2137,4171
6047,MERCED,2019,5,2081,2246,4327
6047,MERCED,2019,6,2137,2170,4307
6047,MERCED,2019,7,2190,2244,4434
6047,MERCED,2019,8,2143,2326,4469
6047,MERCED,2019,9,2188,2302,4490
6047,MERCED,2019,10,2223,2277,4500
6047,MERCED,2019,11,2280,2399,4679
6047,MERCED,2019,12,2407,2461,4868
6047,MERCED,2019,13,2312,2483,4795
6047,MERCED,2019,14,2280,2375,4655
6047,MERCED,2019,15,2268,2366,4634
6047,MERCED,2019,16,2243,2371,4614
6047,MERCED,2019,17,2209,2330,4539
6047,MERCED,2019,18,2797,2989,5786
6047,MERCED,2019,19,2684,2879,5563
6047,MERCED,2019,20,2589,2767,5356
6047,MERCED,2019,21,2447,2622,5069
6047,MERCED,2019,22,2308,2552,4860
6047,MERCED,2019,23,2427,2631,5058
6047,MERCED,2019,24,2119,2429,4548
6047,MERCED,2019,25,2240,2305,4545
6047,MERCED,2019,26,2106,2334,4440
6047,MERCED,2019,27,2059,2215,4274
6047,MERCED,2019,28,1896,2222,4118
6047,MERCED,2019,29,1767,1977,3744
6047,MERCED,2019,30,1706,1790,3496
6047,MERCED,2019,31,1605,1874,3479
6047,MERCED,2019,32,1630,1819,3449
6047,MERCED,2019,33,1712,1914,3626
6047,MERCED,2019,34,1834,2006,3840
6047,MERCED,2019,35,1822,1899,3721
6047,MERCED,2019,36,1820,1890,3710
6047,MERCED,2019,37,1819,1906,3725
6047,MERCED,2019,38,1867,1911,3778
6047,MERCED,2019,39,1787,1956,3743
6047,MERCED,2019,40,1772,1730,3502
6047,MERCED,2019,41,1681,1628,3309
6047,MERCED,2019,42,1646,1654,3300
6047,MERCED,2019,43,1604,1633,3237
6047,MERCED,2019,44,1641,1658,3299
6047,MERCED,2019,45,1601,1552,3153
6047,MERCED,2019,46,1668,1602,3270
6047,MERCED,2019,47,1539,1620,3159
6047,MERCED,2019,48,1590,1602,3192
6047,MERCED,2019,49,1649,1569,3218
6047,MERCED,2019,50,1536,1554,3090
6047,MERCED,2019,51,1481,1574,3055
6047,MERCED,2019,52,1417,1547,2964
6047,MERCED,2019,53,1534,1559,3093
6047,MERCED,2019,54,1561,1534,3095
6047,MERCED,2019,55,1566,1581,3147
6047,MERCED,2019,56,1498,1510,3008
6047,MERCED,2019,57,1641,1454,3095
6047,MERCED,2019,58,1462,1412,2874
6047,MERCED,2019,59,1447,1431,2878
6047,MERCED,2019,60,1378,1370,2748
6047,MERCED,2019,61,1361,1318,2679
6047,MERCED,2019,62,1380,1294,2674
6047,MERCED,2019,63,1339,1250,2589
6047,MERCED,2019,64,1268,1251,2519
6047,MERCED,2019,65,1230,1123,2353
6047,MERCED,2019,66,1164,1062,2226
6047,MERCED,2019,67,1096,1002,2098
6047,MERCED,2019,68,1074,967,2041
6047,MERCED,2019,69,1018,979,1997
6047,MERCED,2019,70,927,957,1884
6047,MERCED,2019,71,977,886,1863
6047,MERCED,2019,72,962,813,1775
6047,MERCED,2019,73,805,708,1513
6047,MERCED,2019,74,787,677,1464
6047,MERCED,2019,75,752,629,1381
6047,MERCED,2019,76,658,584,1242
6047,MERCED,2019,77,578,515,1093
6047,MERCED,2019,78,618,476,1094
6047,MERCED,2019,79,539,443,982
6047,MERCED,2019,80,495,379,874
6047,MERCED,2019,81,493,349,842
6047,MERCED,2019,82,425,299,724
6047,MERCED,2019,83,388,292,680
6047,MERCED,2019,84,368,259,627
6047,MERCED,2019,85,390,235,625
6047,MERCED,2019,86,315,217,532
6047,MERCED,2019,87,313,228,541
6047,MERCED,2019,88,272,155,427
6047,MERCED,2019,89,250,135,385
6047,MERCED,2019,90,192,123,315
6047,MERCED,2019,91,206,96,302
6047,MERCED,2019,92,136,91,227
6047,MERCED,2019,93,137,46,183
6047,MERCED,2019,94,99,31,130
6047,MERCED,2019,95,59,42,101
6047,MERCED,2019,96,50,10,60
6047,MERCED,2019,97,55,18,73
6047,MERCED,2019,98,27,5,32
6047,MERCED,2019,99,12,3,15
6047,MERCED,2019,100,24,5,29
6049,MODOC,2017,0,48,41,89
6049,MODOC,2017,1,44,44,88
6049,MODOC,2017,2,33,34,67
6049,MODOC,2017,3,34,35,69
6049,MODOC,2017,4,48,31,79
6049,MODOC,2017,5,45,29,74
6049,MODOC,2017,6,42,54,96
6049,MODOC,2017,7,50,63,113
6049,MODOC,2017,8,71,46,117
6049,MODOC,2017,9,48,52,100
6049,MODOC,2017,10,62,56,118
6049,MODOC,2017,11,46,56,102
6049,MODOC,2017,12,53,52,105
6049,MODOC,2017,13,53,61,114
6049,MODOC,2017,14,63,61,124
6049,MODOC,2017,15,46,54,100
6049,MODOC,2017,16,52,60,112
6049,MODOC,2017,17,53,61,114
6049,MODOC,2017,18,70,60,130
6049,MODOC,2017,19,60,68,128
6049,MODOC,2017,20,58,60,118
6049,MODOC,2017,21,73,73,146
6049,MODOC,2017,22,81,91,172
6049,MODOC,2017,23,52,76,128
6049,MODOC,2017,24,56,66,122
6049,MODOC,2017,25,47,63,110
6049,MODOC,2017,26,53,38,91
6049,MODOC,2017,27,46,36,82
6049,MODOC,2017,28,31,34,65
6049,MODOC,2017,29,30,41,71
6049,MODOC,2017,30,33,35,68
6049,MODOC,2017,31,53,42,95
6049,MODOC,2017,32,49,47,96
6049,MODOC,2017,33,33,44,77
6049,MODOC,2017,34,45,33,78
6049,MODOC,2017,35,45,52,97
6049,MODOC,2017,36,44,53,97
6049,MODOC,2017,37,46,55,101
6049,MODOC,2017,38,42,43,85
6049,MODOC,2017,39,51,39,90
6049,MODOC,2017,40,47,41,88
6049,MODOC,2017,41,38,51,89
6049,MODOC,2017,42,44,49,93
6049,MODOC,2017,43,38,55,93
6049,MODOC,2017,44,39,52,91
6049,MODOC,2017,45,40,61,101
6049,MODOC,2017,46,47,58,105
6049,MODOC,2017,47,57,61,118
6049,MODOC,2017,48,55,67,122
6049,MODOC,2017,49,54,48,102
6049,MODOC,2017,50,58,50,108
6049,MODOC,2017,51,58,37,95
6049,MODOC,2017,52,59,57,116
6049,MODOC,2017,53,66,50,116
6049,MODOC,2017,54,68,50,118
6049,MODOC,2017,55,90,63,153
6049,MODOC,2017,56,62,78,140
6049,MODOC,2017,57,62,73,135
6049,MODOC,2017,58,79,53,132
6049,MODOC,2017,59,81,72,153
6049,MODOC,2017,60,87,68,155
6049,MODOC,2017,61,61,61,122
6049,MODOC,2017,62,69,85,154
6049,MODOC,2017,63,74,84,158
6049,MODOC,2017,64,83,55,138
6049,MODOC,2017,65,75,75,150
6049,MODOC,2017,66,74,58,132
6049,MODOC,2017,67,76,80,156
6049,MODOC,2017,68,77,70,147
6049,MODOC,2017,69,80,91,171
6049,MODOC,2017,70,87,86,173
6049,MODOC,2017,71,62,48,110
6049,MODOC,2017,72,67,56,123
6049,MODOC,2017,73,57,64,121
6049,MODOC,2017,74,52,60,112
6049,MODOC,2017,75,49,51,100
6049,MODOC,2017,76,48,56,104
6049,MODOC,2017,77,45,54,99
6049,MODOC,2017,78,46,42,88
6049,MODOC,2017,79,33,40,73
6049,MODOC,2017,80,33,31,64
6049,MODOC,2017,81,31,26,57
6049,MODOC,2017,82,30,26,56
6049,MODOC,2017,83,33,26,59
6049,MODOC,2017,84,22,20,42
6049,MODOC,2017,85,31,10,41
6049,MODOC,2017,86,13,27,40
6049,MODOC,2017,87,23,12,35
6049,MODOC,2017,88,15,9,24
6049,MODOC,2017,89,20,7,27
6049,MODOC,2017,90,16,15,31
6049,MODOC,2017,91,4,10,14
6049,MODOC,2017,92,10,7,17
6049,MODOC,2017,93,4,3,7
6049,MODOC,2017,94,10,4,14
6049,MODOC,2017,95,5,2,7
6049,MODOC,2017,96,0,2,2
6049,MODOC,2017,97,0,3,3
6049,MODOC,2017,98,2,0,2
6049,MODOC,2017,99,2,1,3
6049,MODOC,2017,100,0,4,4
6049,MODOC,2018,0,40,47,87
6049,MODOC,2018,1,49,40,89
6049,MODOC,2018,2,43,44,87
6049,MODOC,2018,3,33,34,67
6049,MODOC,2018,4,40,36,76
6049,MODOC,2018,5,44,30,74
6049,MODOC,2018,6,43,31,74
6049,MODOC,2018,7,44,53,97
6049,MODOC,2018,8,52,62,114
6049,MODOC,2018,9,69,47,116
6049,MODOC,2018,10,47,55,102
6049,MODOC,2018,11,62,53,115
6049,MODOC,2018,12,47,56,103
6049,MODOC,2018,13,51,51,102
6049,MODOC,2018,14,54,63,117
6049,MODOC,2018,15,62,59,121
6049,MODOC,2018,16,46,54,100
6049,MODOC,2018,17,52,61,113
6049,MODOC,2018,18,63,67,130
6049,MODOC,2018,19,66,63,129
6049,MODOC,2018,20,59,67,126
6049,MODOC,2018,21,55,57,112
6049,MODOC,2018,22,74,74,148
6049,MODOC,2018,23,80,87,167
6049,MODOC,2018,24,54,82,136
6049,MODOC,2018,25,52,60,112
6049,MODOC,2018,26,47,67,114
6049,MODOC,2018,27,55,33,88
6049,MODOC,2018,28,44,37,81
6049,MODOC,2018,29,30,35,65
6049,MODOC,2018,30,34,39,73
6049,MODOC,2018,31,31,38,69
6049,MODOC,2018,32,54,39,93
6049,MODOC,2018,33,46,45,91
6049,MODOC,2018,34,34,46,80
6049,MODOC,2018,35,45,37,82
6049,MODOC,2018,36,45,46,91
6049,MODOC,2018,37,46,57,103
6049,MODOC,2018,38,44,58,102
6049,MODOC,2018,39,41,39,80
6049,MODOC,2018,40,51,38,89
6049,MODOC,2018,41,47,43,90
6049,MODOC,2018,42,39,47,86
6049,MODOC,2018,43,44,50,94
6049,MODOC,2018,44,41,54,95
6049,MODOC,2018,45,36,54,90
6049,MODOC,2018,46,39,60,99
6049,MODOC,2018,47,47,59,106
6049,MODOC,2018,48,58,62,120
6049,MODOC,2018,49,56,65,121
6049,MODOC,2018,50,53,47,100
6049,MODOC,2018,51,60,48,108
6049,MODOC,2018,52,57,36,93
6049,MODOC,2018,53,61,57,118
6049,MODOC,2018,54,66,47,113
6049,MODOC,2018,55,68,54,122
6049,MODOC,2018,56,91,58,149
6049,MODOC,2018,57,58,77,135
6049,MODOC,2018,58,62,74,136
6049,MODOC,2018,59,79,50,129
6049,MODOC,2018,60,82,75,157
6049,MODOC,2018,61,82,61,143
6049,MODOC,2018,62,61,62,123
6049,MODOC,2018,63,69,80,149
6049,MODOC,2018,64,70,80,150
6049,MODOC,2018,65,80,52,132
6049,MODOC,2018,66,74,77,151
6049,MODOC,2018,67,76,57,133
6049,MODOC,2018,68,74,81,155
6049,MODOC,2018,69,80,67,147
6049,MODOC,2018,70,77,94,171
6049,MODOC,2018,71,84,82,166
6049,MODOC,2018,72,63,47,110
6049,MODOC,2018,73,64,55,119
6049,MODOC,2018,74,57,63,120
6049,MODOC,2018,75,52,56,108
6049,MODOC,2018,76,46,49,95
6049,MODOC,2018,77,47,53,100
6049,MODOC,2018,78,46,54,100
6049,MODOC,2018,79,43,38,81
6049,MODOC,2018,80,33,39,72
6049,MODOC,2018,81,31,30,61
6049,MODOC,2018,82,25,23,48
6049,MODOC,2018,83,30,24,54
6049,MODOC,2018,84,31,24,55
6049,MODOC,2018,85,24,19,43
6049,MODOC,2018,86,24,11,35
6049,MODOC,2018,87,13,25,38
6049,MODOC,2018,88,21,15,36
6049,MODOC,2018,89,10,6,16
6049,MODOC,2018,90,19,5,24
6049,MODOC,2018,91,13,13,26
6049,MODOC,2018,92,2,7,9
6049,MODOC,2018,93,12,7,19
6049,MODOC,2018,94,1,2,3
6049,MODOC,2018,95,10,3,13
6049,MODOC,2018,96,4,1,5
6049,MODOC,2018,97,0,1,1
6049,MODOC,2018,98,0,2,2
6049,MODOC,2018,99,2,0,2
6049,MODOC,2018,100,2,1,3
6049,MODOC,2019,0,48,41,89
6049,MODOC,2019,1,41,47,88
6049,MODOC,2019,2,48,40,88
6049,MODOC,2019,3,43,44,87
6049,MODOC,2019,4,39,35,74
6049,MODOC,2019,5,36,35,71
6049,MODOC,2019,6,42,32,74
6049,MODOC,2019,7,45,30,75
6049,MODOC,2019,8,46,52,98
6049,MODOC,2019,9,50,63,113
6049,MODOC,2019,10,68,50,118
6049,MODOC,2019,11,47,52,99
6049,MODOC,2019,12,63,53,116
6049,MODOC,2019,13,45,55,100
6049,MODOC,2019,14,52,53,105
6049,MODOC,2019,15,53,61,114
6049,MODOC,2019,16,62,59,121
6049,MODOC,2019,17,46,55,101
6049,MODOC,2019,18,61,67,128
6049,MODOC,2019,19,59,70,129
6049,MODOC,2019,20,66,62,128
6049,MODOC,2019,21,56,64,120
6049,MODOC,2019,22,56,58,114
6049,MODOC,2019,23,73,70,143
6049,MODOC,2019,24,82,93,175
6049,MODOC,2019,25,50,76,126
6049,MODOC,2019,26,52,64,116
6049,MODOC,2019,27,49,61,110
6049,MODOC,2019,28,53,34,87
6049,MODOC,2019,29,44,38,82
6049,MODOC,2019,30,33,33,66
6049,MODOC,2019,31,32,42,74
6049,MODOC,2019,32,32,34,66
6049,MODOC,2019,33,51,38,89
6049,MODOC,2019,34,47,47,94
6049,MODOC,2019,35,34,50,84
6049,MODOC,2019,36,45,31,76
6049,MODOC,2019,37,47,50,97
6049,MODOC,2019,38,44,60,104
6049,MODOC,2019,39,43,55,98
6049,MODOC,2019,40,41,38,79
6049,MODOC,2019,41,51,40,91
6049,MODOC,2019,42,48,39,87
6049,MODOC,2019,43,39,48,87
6049,MODOC,2019,44,47,49,96
6049,MODOC,2019,45,38,56,94
6049,MODOC,2019,46,35,53,88
6049,MODOC,2019,47,39,59,98
6049,MODOC,2019,48,48,59,107
6049,MODOC,2019,49,58,61,119
6049,MODOC,2019,50,55,67,122
6049,MODOC,2019,51,54,46,100
6049,MODOC,2019,52,56,48,104
6049,MODOC,2019,53,58,39,97
6049,MODOC,2019,54,61,54,115
6049,MODOC,2019,55,64,51,115
6049,MODOC,2019,56,68,51,119
6049,MODOC,2019,57,87,57,144
6049,MODOC,2019,58,60,79,139
6049,MODOC,2019,59,61,69,130
6049,MODOC,2019,60,80,55,135
6049,MODOC,2019,61,78,70,148
6049,MODOC,2019,62,83,61,144
6049,MODOC,2019,63,62,62,124
6049,MODOC,2019,64,64,77,141
6049,MODOC,2019,65,69,77,146
6049,MODOC,2019,66,81,54,135
6049,MODOC,2019,67,75,77,152
6049,MODOC,2019,68,75,57,132
6049,MODOC,2019,69,74,80,154
6049,MODOC,2019,70,76,68,144
6049,MODOC,2019,71,75,88,163
6049,MODOC,2019,72,82,81,163
6049,MODOC,2019,73,58,44,102
6049,MODOC,2019,74,64,54,118
6049,MODOC,2019,75,59,62,121
6049,MODOC,2019,76,51,54,105
6049,MODOC,2019,77,42,47,89
6049,MODOC,2019,78,49,54,103
6049,MODOC,2019,79,44,51,95
6049,MODOC,2019,80,41,37,78
6049,MODOC,2019,81,35,38,73
6049,MODOC,2019,82,27,26,53
6049,MODOC,2019,83,24,20,44
6049,MODOC,2019,84,27,22,49
6049,MODOC,2019,85,31,22,53
6049,MODOC,2019,86,19,19,38
6049,MODOC,2019,87,19,9,28
6049,MODOC,2019,88,13,21,34
6049,MODOC,2019,89,19,12,31
6049,MODOC,2019,90,9,4,13
6049,MODOC,2019,91,16,5,21
6049,MODOC,2019,92,12,10,22
6049,MODOC,2019,93,6,7,13
6049,MODOC,2019,94,6,5,11
6049,MODOC,2019,95,1,1,2
6049,MODOC,2019,96,7,2,9
6049,MODOC,2019,97,2,1,3
6049,MODOC,2019,99,0,2,2
6049,MODOC,2019,100,4,1,5
6051,MONO,2017,0,60,75,135
6051,MONO,2017,1,69,69,138
6051,MONO,2017,2,65,84,149
6051,MONO,2017,3,75,72,147
6051,MONO,2017,4,53,73,126
6051,MONO,2017,5,74,64,138
6051,MONO,2017,6,65,79,144
6051,MONO,2017,7,77,70,147
6051,MONO,2017,8,107,84,191
6051,MONO,2017,9,92,87,179
6051,MONO,2017,10,79,83,162
6051,MONO,2017,11,84,101,185
6051,MONO,2017,12,94,87,181
6051,MONO,2017,13,83,100,183
6051,MONO,2017,14,70,74,144
6051,MONO,2017,15,93,80,173
6051,MONO,2017,16,78,88,166
6051,MONO,2017,17,70,78,148
6051,MONO,2017,18,76,76,152
6051,MONO,2017,19,79,67,146
6051,MONO,2017,20,70,72,142
6051,MONO,2017,21,71,76,147
6051,MONO,2017,22,58,47,105
6051,MONO,2017,23,66,78,144
6051,MONO,2017,24,69,82,151
6051,MONO,2017,25,58,84,142
6051,MONO,2017,26,63,71,134
6051,MONO,2017,27,70,84,154
6051,MONO,2017,28,87,114,201
6051,MONO,2017,29,79,84,163
6051,MONO,2017,30,95,142,237
6051,MONO,2017,31,108,144,252
6051,MONO,2017,32,104,137,241
6051,MONO,2017,33,99,134,233
6051,MONO,2017,34,81,137,218
6051,MONO,2017,35,135,142,277
6051,MONO,2017,36,107,119,226
6051,MONO,2017,37,94,103,197
6051,MONO,2017,38,98,99,197
6051,MONO,2017,39,60,113,173
6051,MONO,2017,40,72,83,155
6051,MONO,2017,41,80,94,174
6051,MONO,2017,42,75,103,178
6051,MONO,2017,43,69,102,171
6051,MONO,2017,44,101,95,196
6051,MONO,2017,45,71,91,162
6051,MONO,2017,46,88,103,191
6051,MONO,2017,47,97,112,209
6051,MONO,2017,48,85,98,183
6051,MONO,2017,49,76,81,157
6051,MONO,2017,50,58,99,157
6051,MONO,2017,51,90,108,198
6051,MONO,2017,52,105,111,216
6051,MONO,2017,53,103,102,205
6051,MONO,2017,54,110,102,212
6051,MONO,2017,55,122,104,226
6051,MONO,2017,56,115,117,232
6051,MONO,2017,57,140,134,274
6051,MONO,2017,58,107,128,235
6051,MONO,2017,59,126,135,261
6051,MONO,2017,60,101,139,240
6051,MONO,2017,61,111,117,228
6051,MONO,2017,62,116,94,210
6051,MONO,2017,63,98,103,201
6051,MONO,2017,64,99,106,205
6051,MONO,2017,65,82,114,196
6051,MONO,2017,66,91,104,195
6051,MONO,2017,67,80,99,179
6051,MONO,2017,68,97,94,191
6051,MONO,2017,69,79,76,155
6051,MONO,2017,70,46,76,122
6051,MONO,2017,71,63,58,121
6051,MONO,2017,72,41,53,94
6051,MONO,2017,73,49,56,105
6051,MONO,2017,74,53,67,120
6051,MONO,2017,75,34,34,68
6051,MONO,2017,76,25,31,56
6051,MONO,2017,77,35,25,60
6051,MONO,2017,78,27,19,46
6051,MONO,2017,79,21,17,38
6051,MONO,2017,80,11,20,31
6051,MONO,2017,81,15,8,23
6051,MONO,2017,82,3,12,15
6051,MONO,2017,83,5,3,8
6051,MONO,2017,84,5,10,15
6051,MONO,2017,85,4,4,8
6051,MONO,2017,86,6,11,17
6051,MONO,2017,87,0,5,5
6051,MONO,2017,88,1,3,4
6051,MONO,2017,89,0,4,4
6051,MONO,2017,91,2,1,3
6051,MONO,2017,92,4,0,4
6051,MONO,2018,0,61,71,132
6051,MONO,2018,1,60,75,135
6051,MONO,2018,2,69,68,137
6051,MONO,2018,3,65,83,148
6051,MONO,2018,4,75,72,147
6051,MONO,2018,5,53,73,126
6051,MONO,2018,6,74,65,139
6051,MONO,2018,7,65,79,144
6051,MONO,2018,8,77,71,148
6051,MONO,2018,9,107,84,191
6051,MONO,2018,10,93,87,180
6051,MONO,2018,11,79,83,162
6051,MONO,2018,12,84,101,185
6051,MONO,2018,13,94,87,181
6051,MONO,2018,14,83,100,183
6051,MONO,2018,15,70,74,144
6051,MONO,2018,16,93,82,175
6051,MONO,2018,17,78,89,167
6051,MONO,2018,18,67,77,144
6051,MONO,2018,19,82,69,151
6051,MONO,2018,20,76,77,153
6051,MONO,2018,21,71,76,147
6051,MONO,2018,22,67,69,136
6051,MONO,2018,23,65,56,121
6051,MONO,2018,24,65,81,146
6051,MONO,2018,25,61,77,138
6051,MONO,2018,26,60,73,133
6051,MONO,2018,27,63,84,147
6051,MONO,2018,28,70,75,145
6051,MONO,2018,29,85,114,199
6051,MONO,2018,30,77,86,163
6051,MONO,2018,31,97,127,224
6051,MONO,2018,32,109,153,262
6051,MONO,2018,33,104,131,235
6051,MONO,2018,34,96,129,225
6051,MONO,2018,35,81,137,218
6051,MONO,2018,36,137,146,283
6051,MONO,2018,37,105,118,223
6051,MONO,2018,38,94,102,196
6051,MONO,2018,39,98,96,194
6051,MONO,2018,40,60,117,177
6051,MONO,2018,41,73,79,152
6051,MONO,2018,42,83,96,179
6051,MONO,2018,43,71,99,170
6051,MONO,2018,44,68,103,171
6051,MONO,2018,45,99,96,195
6051,MONO,2018,46,71,92,163
6051,MONO,2018,47,89,108,197
6051,MONO,2018,48,96,106,202
6051,MONO,2018,49,87,98,185
6051,MONO,2018,50,74,81,155
6051,MONO,2018,51,58,104,162
6051,MONO,2018,52,90,104,194
6051,MONO,2018,53,105,108,213
6051,MONO,2018,54,103,101,204
6051,MONO,2018,55,112,103,215
6051,MONO,2018,56,120,101,221
6051,MONO,2018,57,116,118,234
6051,MONO,2018,58,144,138,282
6051,MONO,2018,59,109,128,237
6051,MONO,2018,60,126,132,258
6051,MONO,2018,61,102,139,241
6051,MONO,2018,62,109,115,224
6051,MONO,2018,63,115,92,207
6051,MONO,2018,64,98,103,201
6051,MONO,2018,65,98,103,201
6051,MONO,2018,66,81,111,192
6051,MONO,2018,67,90,103,193
6051,MONO,2018,68,78,98,176
6051,MONO,2018,69,96,93,189
6051,MONO,2018,70,78,75,153
6051,MONO,2018,71,45,75,120
6051,MONO,2018,72,62,55,117
6051,MONO,2018,73,40,53,93
6051,MONO,2018,74,47,54,101
6051,MONO,2018,75,53,64,117
6051,MONO,2018,76,31,32,63
6051,MONO,2018,77,23,31,54
6051,MONO,2018,78,35,23,58
6051,MONO,2018,79,26,18,44
6051,MONO,2018,80,20,16,36
6051,MONO,2018,81,11,17,28
6051,MONO,2018,82,15,8,23
6051,MONO,2018,83,3,11,14
6051,MONO,2018,84,5,3,8
6051,MONO,2018,85,5,9,14
6051,MONO,2018,86,3,4,7
6051,MONO,2018,87,3,9,12
6051,MONO,2018,88,0,5,5
6051,MONO,2018,89,1,3,4
6051,MONO,2018,90,0,3,3
6051,MONO,2018,92,1,1,2
6051,MONO,2018,93,4,0,4
6051,MONO,2019,0,56,79,135
6051,MONO,2019,1,61,71,132
6051,MONO,2019,2,60,75,135
6051,MONO,2019,3,68,68,136
6051,MONO,2019,4,65,83,148
6051,MONO,2019,5,75,72,147
6051,MONO,2019,6,53,74,127
6051,MONO,2019,7,74,65,139
6051,MONO,2019,8,65,80,145
6051,MONO,2019,9,77,72,149
6051,MONO,2019,10,107,84,191
6051,MONO,2019,11,93,87,180
6051,MONO,2019,12,79,83,162
6051,MONO,2019,13,84,101,185
6051,MONO,2019,14,94,87,181
6051,MONO,2019,15,83,100,183
6051,MONO,2019,16,71,76,147
6051,MONO,2019,17,94,83,177
6051,MONO,2019,18,77,92,169
6051,MONO,2019,19,73,67,140
6051,MONO,2019,20,77,77,154
6051,MONO,2019,21,78,79,157
6051,MONO,2019,22,67,69,136
6051,MONO,2019,23,74,78,152
6051,MONO,2019,24,65,59,124
6051,MONO,2019,25,57,76,133
6051,MONO,2019,26,63,67,130
6051,MONO,2019,27,60,86,146
6051,MONO,2019,28,62,76,138
6051,MONO,2019,29,68,76,144
6051,MONO,2019,30,83,114,197
6051,MONO,2019,31,79,72,151
6051,MONO,2019,32,98,136,234
6051,MONO,2019,33,107,147,254
6051,MONO,2019,34,101,127,228
6051,MONO,2019,35,96,128,224
6051,MONO,2019,36,83,142,225
6051,MONO,2019,37,135,144,279
6051,MONO,2019,38,105,117,222
6051,MONO,2019,39,94,99,193
6051,MONO,2019,40,98,101,199
6051,MONO,2019,41,61,112,173
6051,MONO,2019,42,76,81,157
6051,MONO,2019,43,78,92,170
6051,MONO,2019,44,71,100,171
6051,MONO,2019,45,67,104,171
6051,MONO,2019,46,100,96,196
6051,MONO,2019,47,72,95,167
6051,MONO,2019,48,88,101,189
6051,MONO,2019,49,98,106,204
6051,MONO,2019,50,86,98,184
6051,MONO,2019,51,74,87,161
6051,MONO,2019,52,58,100,158
6051,MONO,2019,53,90,100,190
6051,MONO,2019,54,105,107,212
6051,MONO,2019,55,105,102,207
6051,MONO,2019,56,112,102,214
6051,MONO,2019,57,121,104,225
6051,MONO,2019,58,120,118,238
6051,MONO,2019,59,146,140,286
6051,MONO,2019,60,110,128,238
6051,MONO,2019,61,125,131,256
6051,MONO,2019,62,101,138,239
6051,MONO,2019,63,107,115,222
6051,MONO,2019,64,114,94,208
6051,MONO,2019,65,97,100,197
6051,MONO,2019,66,98,101,199
6051,MONO,2019,67,81,109,190
6051,MONO,2019,68,90,103,193
6051,MONO,2019,69,78,97,175
6051,MONO,2019,70,94,89,183
6051,MONO,2019,71,76,72,148
6051,MONO,2019,72,44,75,119
6051,MONO,2019,73,61,55,116
6051,MONO,2019,74,39,51,90
6051,MONO,2019,75,47,54,101
6051,MONO,2019,76,50,60,110
6051,MONO,2019,77,31,31,62
6051,MONO,2019,78,23,28,51
6051,MONO,2019,79,35,22,57
6051,MONO,2019,80,25,18,43
6051,MONO,2019,81,20,13,33
6051,MONO,2019,82,11,16,27
6051,MONO,2019,83,14,6,20
6051,MONO,2019,84,3,9,12
6051,MONO,2019,85,5,3,8
6051,MONO,2019,86,3,8,11
6051,MONO,2019,87,2,4,6
6051,MONO,2019,88,3,9,12
6051,MONO,2019,89,0,4,4
6051,MONO,2019,90,1,3,4
6051,MONO,2019,91,0,3,3
6051,MONO,2019,93,0,1,1
6051,MONO,2019,94,4,0,4
6053,MONTEREY,2017,0,3009,3286,6295
6053,MONTEREY,2017,1,3039,3258,6297
6053,MONTEREY,2017,2,3113,3222,6335
6053,MONTEREY,2017,3,3108,3152,6260
6053,MONTEREY,2017,4,3199,3214,6413
6053,MONTEREY,2017,5,3248,3441,6689
6053,MONTEREY,2017,6,3330,3447,6777
6053,MONTEREY,2017,7,3060,3322,6382
6053,MONTEREY,2017,8,3122,3355,6477
6053,MONTEREY,2017,9,3263,3435,6698
6053,MONTEREY,2017,10,3294,3402,6696
6053,MONTEREY,2017,11,3170,3303,6473
6053,MONTEREY,2017,12,3063,3331,6394
6053,MONTEREY,2017,13,2995,3305,6300
6053,MONTEREY,2017,14,2944,3156,6100
6053,MONTEREY,2017,15,3043,3082,6125
6053,MONTEREY,2017,16,2811,3092,5903
6053,MONTEREY,2017,17,2936,3027,5963
6053,MONTEREY,2017,18,3549,3837,7386
6053,MONTEREY,2017,19,3740,3847,7587
6053,MONTEREY,2017,20,3429,3819,7248
6053,MONTEREY,2017,21,3286,3740,7026
6053,MONTEREY,2017,22,3201,3573,6774
6053,MONTEREY,2017,23,3148,3626,6774
6053,MONTEREY,2017,24,3274,3692,6966
6053,MONTEREY,2017,25,2918,3373,6291
6053,MONTEREY,2017,26,2802,3291,6093
6053,MONTEREY,2017,27,2698,3204,5902
6053,MONTEREY,2017,28,2426,3048,5474
6053,MONTEREY,2017,29,2414,2948,5362
6053,MONTEREY,2017,30,2540,3122,5662
6053,MONTEREY,2017,31,2700,3251,5951
6053,MONTEREY,2017,32,2868,3368,6236
6053,MONTEREY,2017,33,2841,3515,6356
6053,MONTEREY,2017,34,2974,3533,6507
6053,MONTEREY,2017,35,2936,3563,6499
6053,MONTEREY,2017,36,2969,3393,6362
6053,MONTEREY,2017,37,3014,3432,6446
6053,MONTEREY,2017,38,2822,3306,6128
6053,MONTEREY,2017,39,2737,3143,5880
6053,MONTEREY,2017,40,2697,3151,5848
6053,MONTEREY,2017,41,2654,3135,5789
6053,MONTEREY,2017,42,2613,3093,5706
6053,MONTEREY,2017,43,2577,2988,5565
6053,MONTEREY,2017,44,2554,3053,5607
6053,MONTEREY,2017,45,2649,2934,5583
6053,MONTEREY,2017,46,2558,3111,5669
6053,MONTEREY,2017,47,2703,2995,5698
6053,MONTEREY,2017,48,2450,2821,5271
6053,MONTEREY,2017,49,2349,2750,5099
6053,MONTEREY,2017,50,2325,2676,5001
6053,MONTEREY,2017,51,2442,2665,5107
6053,MONTEREY,2017,52,2482,2594,5076
6053,MONTEREY,2017,53,2417,2657,5074
6053,MONTEREY,2017,54,2482,2598,5080
6053,MONTEREY,2017,55,2545,2599,5144
6053,MONTEREY,2017,56,2534,2408,4942
6053,MONTEREY,2017,57,2739,2587,5326
6053,MONTEREY,2017,58,2502,2539,5041
6053,MONTEREY,2017,59,2555,2436,4991
6053,MONTEREY,2017,60,2614,2314,4928
6053,MONTEREY,2017,61,2412,2363,4775
6053,MONTEREY,2017,62,2474,2557,5031
6053,MONTEREY,2017,63,2348,2250,4598
6053,MONTEREY,2017,64,2246,2205,4451
6053,MONTEREY,2017,65,2239,2085,4324
6053,MONTEREY,2017,66,2197,1883,4080
6053,MONTEREY,2017,67,2078,1938,4016
6053,MONTEREY,2017,68,2067,1848,3915
6053,MONTEREY,2017,69,1925,1893,3818
6053,MONTEREY,2017,70,1897,1760,3657
6053,MONTEREY,2017,71,1598,1428,3026
6053,MONTEREY,2017,72,1530,1322,2852
6053,MONTEREY,2017,73,1379,1241,2620
6053,MONTEREY,2017,74,1288,1189,2477
6053,MONTEREY,2017,75,1197,1019,2216
6053,MONTEREY,2017,76,1105,862,1967
6053,MONTEREY,2017,77,1011,894,1905
6053,MONTEREY,2017,78,892,815,1707
6053,MONTEREY,2017,79,873,712,1585
6053,MONTEREY,2017,80,857,676,1533
6053,MONTEREY,2017,81,800,623,1423
6053,MONTEREY,2017,82,837,577,1414
6053,MONTEREY,2017,83,743,508,1251
6053,MONTEREY,2017,84,697,481,1178
6053,MONTEREY,2017,85,711,478,1189
6053,MONTEREY,2017,86,721,489,1210
6053,MONTEREY,2017,87,639,405,1044
6053,MONTEREY,2017,88,590,317,907
6053,MONTEREY,2017,89,523,330,853
6053,MONTEREY,2017,90,489,262,751
6053,MONTEREY,2017,91,437,225,662
6053,MONTEREY,2017,92,305,153,458
6053,MONTEREY,2017,93,244,122,366
6053,MONTEREY,2017,94,201,108,309
6053,MONTEREY,2017,95,190,91,281
6053,MONTEREY,2017,96,118,50,168
6053,MONTEREY,2017,97,100,42,142
6053,MONTEREY,2017,98,72,17,89
6053,MONTEREY,2017,99,28,15,43
6053,MONTEREY,2017,100,68,17,85
6053,MONTEREY,2018,0,3037,3249,6286
6053,MONTEREY,2018,1,2990,3274,6264
6053,MONTEREY,2018,2,3039,3247,6286
6053,MONTEREY,2018,3,3114,3222,6336
6053,MONTEREY,2018,4,3110,3152,6262
6053,MONTEREY,2018,5,3201,3215,6416
6053,MONTEREY,2018,6,3244,3446,6690
6053,MONTEREY,2018,7,3334,3442,6776
6053,MONTEREY,2018,8,3060,3324,6384
6053,MONTEREY,2018,9,3123,3352,6475
6053,MONTEREY,2018,10,3264,3448,6712
6053,MONTEREY,2018,11,3295,3401,6696
6053,MONTEREY,2018,12,3183,3305,6488
6053,MONTEREY,2018,13,3061,3333,6394
6053,MONTEREY,2018,14,2995,3302,6297
6053,MONTEREY,2018,15,2956,3172,6128
6053,MONTEREY,2018,16,3043,3072,6115
6053,MONTEREY,2018,17,2863,3140,6003
6053,MONTEREY,2018,18,3612,3790,7402
6053,MONTEREY,2018,19,3651,3939,7590
6053,MONTEREY,2018,20,3414,3746,7160
6053,MONTEREY,2018,21,3350,3772,7122
6053,MONTEREY,2018,22,3313,3704,7017
6053,MONTEREY,2018,23,3159,3569,6728
6053,MONTEREY,2018,24,3210,3658,6868
6053,MONTEREY,2018,25,2977,3378,6355
6053,MONTEREY,2018,26,2865,3262,6127
6053,MONTEREY,2018,27,2803,3288,6091
6053,MONTEREY,2018,28,2683,3243,5926
6053,MONTEREY,2018,29,2437,2995,5432
6053,MONTEREY,2018,30,2403,3077,5480
6053,MONTEREY,2018,31,2543,3138,5681
6053,MONTEREY,2018,32,2722,3155,5877
6053,MONTEREY,2018,33,2865,3432,6297
6053,MONTEREY,2018,34,2843,3526,6369
6053,MONTEREY,2018,35,2978,3505,6483
6053,MONTEREY,2018,36,2928,3527,6455
6053,MONTEREY,2018,37,2978,3380,6358
6053,MONTEREY,2018,38,3002,3443,6445
6053,MONTEREY,2018,39,2824,3312,6136
6053,MONTEREY,2018,40,2738,3227,5965
6053,MONTEREY,2018,41,2702,3092,5794
6053,MONTEREY,2018,42,2645,3145,5790
6053,MONTEREY,2018,43,2614,3121,5735
6053,MONTEREY,2018,44,2585,3004,5589
6053,MONTEREY,2018,45,2554,3000,5554
6053,MONTEREY,2018,46,2631,2998,5629
6053,MONTEREY,2018,47,2555,3028,5583
6053,MONTEREY,2018,48,2707,3009,5716
6053,MONTEREY,2018,49,2442,2805,5247
6053,MONTEREY,2018,50,2343,2674,5017
6053,MONTEREY,2018,51,2316,2659,4975
6053,MONTEREY,2018,52,2433,2604,5037
6053,MONTEREY,2018,53,2483,2598,5081
6053,MONTEREY,2018,54,2415,2666,5081
6053,MONTEREY,2018,55,2472,2492,4964
6053,MONTEREY,2018,56,2530,2581,5111
6053,MONTEREY,2018,57,2524,2377,4901
6053,MONTEREY,2018,58,2712,2555,5267
6053,MONTEREY,2018,59,2498,2514,5012
6053,MONTEREY,2018,60,2541,2388,4929
6053,MONTEREY,2018,61,2616,2310,4926
6053,MONTEREY,2018,62,2402,2362,4764
6053,MONTEREY,2018,63,2467,2535,5002
6053,MONTEREY,2018,64,2327,2206,4533
6053,MONTEREY,2018,65,2246,2159,4405
6053,MONTEREY,2018,66,2221,2056,4277
6053,MONTEREY,2018,67,2165,1866,4031
6053,MONTEREY,2018,68,2065,1894,3959
6053,MONTEREY,2018,69,2045,1843,3888
6053,MONTEREY,2018,70,1916,1850,3766
6053,MONTEREY,2018,71,1852,1734,3586
6053,MONTEREY,2018,72,1580,1394,2974
6053,MONTEREY,2018,73,1506,1283,2789
6053,MONTEREY,2018,74,1358,1216,2574
6053,MONTEREY,2018,75,1272,1171,2443
6053,MONTEREY,2018,76,1178,977,2155
6053,MONTEREY,2018,77,1090,826,1916
6053,MONTEREY,2018,78,975,865,1840
6053,MONTEREY,2018,79,883,789,1672
6053,MONTEREY,2018,80,873,701,1574
6053,MONTEREY,2018,81,809,645,1454
6053,MONTEREY,2018,82,770,586,1356
6053,MONTEREY,2018,83,801,539,1340
6053,MONTEREY,2018,84,734,466,1200
6053,MONTEREY,2018,85,712,454,1166
6053,MONTEREY,2018,86,650,435,1085
6053,MONTEREY,2018,87,640,436,1076
6053,MONTEREY,2018,88,608,360,968
6053,MONTEREY,2018,89,545,295,840
6053,MONTEREY,2018,90,472,299,771
6053,MONTEREY,2018,91,431,219,650
6053,MONTEREY,2018,92,379,190,569
6053,MONTEREY,2018,93,260,126,386
6053,MONTEREY,2018,94,200,99,299
6053,MONTEREY,2018,95,173,87,260
6053,MONTEREY,2018,96,153,63,216
6053,MONTEREY,2018,97,83,32,115
6053,MONTEREY,2018,98,73,27,100
6053,MONTEREY,2018,99,62,11,73
6053,MONTEREY,2018,100,69,22,91
6053,MONTEREY,2019,0,2984,3266,6250
6053,MONTEREY,2019,1,3023,3243,6266
6053,MONTEREY,2019,2,2989,3265,6254
6053,MONTEREY,2019,3,3039,3247,6286
6053,MONTEREY,2019,4,3115,3222,6337
6053,MONTEREY,2019,5,3111,3153,6264
6053,MONTEREY,2019,6,3196,3219,6415
6053,MONTEREY,2019,7,3248,3442,6690
6053,MONTEREY,2019,8,3333,3443,6776
6053,MONTEREY,2019,9,3059,3321,6380
6053,MONTEREY,2019,10,3123,3367,6490
6053,MONTEREY,2019,11,3265,3445,6710
6053,MONTEREY,2019,12,3302,3405,6707
6053,MONTEREY,2019,13,3179,3306,6485
6053,MONTEREY,2019,14,3063,3332,6395
6053,MONTEREY,2019,15,3014,3314,6328
6053,MONTEREY,2019,16,2952,3158,6110
6053,MONTEREY,2019,17,3096,3126,6222
6053,MONTEREY,2019,18,3535,3898,7433
6053,MONTEREY,2019,19,3707,3892,7599
6053,MONTEREY,2019,20,3327,3835,7162
6053,MONTEREY,2019,21,3336,3696,7032
6053,MONTEREY,2019,22,3371,3742,7113
6053,MONTEREY,2019,23,3260,3696,6956
6053,MONTEREY,2019,24,3211,3597,6808
6053,MONTEREY,2019,25,2908,3337,6245
6053,MONTEREY,2019,26,2922,3263,6185
6053,MONTEREY,2019,27,2866,3260,6126
6053,MONTEREY,2019,28,2788,3331,6119
6053,MONTEREY,2019,29,2690,3194,5884
6053,MONTEREY,2019,30,2424,3121,5545
6053,MONTEREY,2019,31,2413,3086,5499
6053,MONTEREY,2019,32,2555,3038,5593
6053,MONTEREY,2019,33,2715,3222,5937
6053,MONTEREY,2019,34,2870,3444,6314
6053,MONTEREY,2019,35,2844,3498,6342
6053,MONTEREY,2019,36,2973,3477,6450
6053,MONTEREY,2019,37,2935,3517,6452
6053,MONTEREY,2019,38,2966,3389,6355
6053,MONTEREY,2019,39,3004,3453,6457
6053,MONTEREY,2019,40,2826,3397,6223
6053,MONTEREY,2019,41,2744,3168,5912
6053,MONTEREY,2019,42,2693,3100,5793
6053,MONTEREY,2019,43,2643,3181,5824
6053,MONTEREY,2019,44,2625,3136,5761
6053,MONTEREY,2019,45,2582,2945,5527
6053,MONTEREY,2019,46,2538,3060,5598
6053,MONTEREY,2019,47,2629,2909,5538
6053,MONTEREY,2019,48,2562,3046,5608
6053,MONTEREY,2019,49,2699,2988,5687
6053,MONTEREY,2019,50,2436,2729,5165
6053,MONTEREY,2019,51,2334,2664,4998
6053,MONTEREY,2019,52,2308,2603,4911
6053,MONTEREY,2019,53,2432,2614,5046
6053,MONTEREY,2019,54,2481,2606,5087
6053,MONTEREY,2019,55,2402,2553,4955
6053,MONTEREY,2019,56,2454,2477,4931
6053,MONTEREY,2019,57,2530,2555,5085
6053,MONTEREY,2019,58,2505,2343,4848
6053,MONTEREY,2019,59,2704,2533,5237
6053,MONTEREY,2019,60,2481,2470,4951
6053,MONTEREY,2019,61,2539,2375,4914
6053,MONTEREY,2019,62,2605,2290,4895
6053,MONTEREY,2019,63,2404,2339,4743
6053,MONTEREY,2019,64,2444,2495,4939
6053,MONTEREY,2019,65,2331,2166,4497
6053,MONTEREY,2019,66,2227,2128,4355
6053,MONTEREY,2019,67,2196,2037,4233
6053,MONTEREY,2019,68,2148,1823,3971
6053,MONTEREY,2019,69,2049,1880,3929
6053,MONTEREY,2019,70,2030,1804,3834
6053,MONTEREY,2019,71,1882,1829,3711
6053,MONTEREY,2019,72,1832,1694,3526
6053,MONTEREY,2019,73,1560,1359,2919
6053,MONTEREY,2019,74,1482,1263,2745
6053,MONTEREY,2019,75,1341,1199,2540
6053,MONTEREY,2019,76,1235,1123,2358
6053,MONTEREY,2019,77,1150,945,2095
6053,MONTEREY,2019,78,1062,796,1858
6053,MONTEREY,2019,79,971,843,1814
6053,MONTEREY,2019,80,883,777,1660
6053,MONTEREY,2019,81,833,666,1499
6053,MONTEREY,2019,82,775,601,1376
6053,MONTEREY,2019,83,735,552,1287
6053,MONTEREY,2019,84,781,511,1292
6053,MONTEREY,2019,85,753,457,1210
6053,MONTEREY,2019,86,661,413,1074
6053,MONTEREY,2019,87,581,396,977
6053,MONTEREY,2019,88,608,388,996
6053,MONTEREY,2019,89,560,329,889
6053,MONTEREY,2019,90,494,265,759
6053,MONTEREY,2019,91,411,243,654
6053,MONTEREY,2019,92,381,183,564
6053,MONTEREY,2019,93,305,153,458
6053,MONTEREY,2019,94,219,102,321
6053,MONTEREY,2019,95,164,86,250
6053,MONTEREY,2019,96,140,65,205
6053,MONTEREY,2019,97,115,44,159
6053,MONTEREY,2019,98,63,23,86
6053,MONTEREY,2019,99,55,22,77
6053,MONTEREY,2019,100,98,23,121
6055,NAPA,2017,0,665,739,1404
6055,NAPA,2017,1,701,753,1454
6055,NAPA,2017,2,683,767,1450
6055,NAPA,2017,3,735,750,1485
6055,NAPA,2017,4,705,708,1413
6055,NAPA,2017,5,715,816,1531
6055,NAPA,2017,6,707,799,1506
6055,NAPA,2017,7,737,797,1534
6055,NAPA,2017,8,851,774,1625
6055,NAPA,2017,9,759,859,1618
6055,NAPA,2017,10,806,886,1692
6055,NAPA,2017,11,843,933,1776
6055,NAPA,2017,12,857,908,1765
6055,NAPA,2017,13,827,934,1761
6055,NAPA,2017,14,951,890,1841
6055,NAPA,2017,15,882,933,1815
6055,NAPA,2017,16,985,1000,1985
6055,NAPA,2017,17,909,902,1811
6055,NAPA,2017,18,982,950,1932
6055,NAPA,2017,19,943,1014,1957
6055,NAPA,2017,20,963,1010,1973
6055,NAPA,2017,21,890,1019,1909
6055,NAPA,2017,22,971,920,1891
6055,NAPA,2017,23,959,1032,1991
6055,NAPA,2017,24,944,1050,1994
6055,NAPA,2017,25,914,1025,1939
6055,NAPA,2017,26,878,982,1860
6055,NAPA,2017,27,839,1042,1881
6055,NAPA,2017,28,824,1018,1842
6055,NAPA,2017,29,766,982,1748
6055,NAPA,2017,30,873,893,1766
6055,NAPA,2017,31,864,911,1775
6055,NAPA,2017,32,941,1037,1978
6055,NAPA,2017,33,835,1022,1857
6055,NAPA,2017,34,878,1009,1887
6055,NAPA,2017,35,886,972,1858
6055,NAPA,2017,36,838,864,1702
6055,NAPA,2017,37,830,971,1801
6055,NAPA,2017,38,835,936,1771
6055,NAPA,2017,39,786,831,1617
6055,NAPA,2017,40,786,791,1577
6055,NAPA,2017,41,791,796,1587
6055,NAPA,2017,42,772,846,1618
6055,NAPA,2017,43,803,841,1644
6055,NAPA,2017,44,831,866,1697
6055,NAPA,2017,45,852,855,1707
6055,NAPA,2017,46,876,907,1783
6055,NAPA,2017,47,947,938,1885
6055,NAPA,2017,48,951,932,1883
6055,NAPA,2017,49,948,853,1801
6055,NAPA,2017,50,859,919,1778
6055,NAPA,2017,51,957,940,1897
6055,NAPA,2017,52,918,921,1839
6055,NAPA,2017,53,1034,957,1991
6055,NAPA,2017,54,986,1019,2005
6055,NAPA,2017,55,1048,969,2017
6055,NAPA,2017,56,1070,982,2052
6055,NAPA,2017,57,1139,1084,2223
6055,NAPA,2017,58,1013,929,1942
6055,NAPA,2017,59,1038,948,1986
6055,NAPA,2017,60,1043,914,1957
6055,NAPA,2017,61,949,973,1922
6055,NAPA,2017,62,928,886,1814
6055,NAPA,2017,63,935,842,1777
6055,NAPA,2017,64,955,799,1754
6055,NAPA,2017,65,940,769,1709
6055,NAPA,2017,66,874,873,1747
6055,NAPA,2017,67,851,778,1629
6055,NAPA,2017,68,793,785,1578
6055,NAPA,2017,69,833,815,1648
6055,NAPA,2017,70,831,780,1611
6055,NAPA,2017,71,741,613,1354
6055,NAPA,2017,72,684,580,1264
6055,NAPA,2017,73,642,617,1259
6055,NAPA,2017,74,620,532,1152
6055,NAPA,2017,75,600,560,1160
6055,NAPA,2017,76,560,461,1021
6055,NAPA,2017,77,526,461,987
6055,NAPA,2017,78,450,398,848
6055,NAPA,2017,79,404,399,803
6055,NAPA,2017,80,390,324,714
6055,NAPA,2017,81,375,354,729
6055,NAPA,2017,82,361,270,631
6055,NAPA,2017,83,291,260,551
6055,NAPA,2017,84,287,247,534
6055,NAPA,2017,85,291,212,503
6055,NAPA,2017,86,311,185,496
6055,NAPA,2017,87,237,176,413
6055,NAPA,2017,88,234,133,367
6055,NAPA,2017,89,239,119,358
6055,NAPA,2017,90,200,101,301
6055,NAPA,2017,91,185,64,249
6055,NAPA,2017,92,135,59,194
6055,NAPA,2017,93,108,42,150
6055,NAPA,2017,94,95,27,122
6055,NAPA,2017,95,69,18,87
6055,NAPA,2017,96,59,13,72
6055,NAPA,2017,97,51,3,54
6055,NAPA,2017,98,34,1,35
6055,NAPA,2017,99,22,1,23
6055,NAPA,2017,100,11,3,14
6055,NAPA,2018,0,734,752,1486
6055,NAPA,2018,1,661,736,1397
6055,NAPA,2018,2,698,754,1452
6055,NAPA,2018,3,685,769,1454
6055,NAPA,2018,4,735,747,1482
6055,NAPA,2018,5,707,711,1418
6055,NAPA,2018,6,714,821,1535
6055,NAPA,2018,7,711,800,1511
6055,NAPA,2018,8,739,796,1535
6055,NAPA,2018,9,855,783,1638
6055,NAPA,2018,10,760,863,1623
6055,NAPA,2018,11,819,889,1708
6055,NAPA,2018,12,859,942,1801
6055,NAPA,2018,13,869,907,1776
6055,NAPA,2018,14,829,933,1762
6055,NAPA,2018,15,976,907,1883
6055,NAPA,2018,16,957,1032,1989
6055,NAPA,2018,17,888,867,1755
6055,NAPA,2018,18,969,953,1922
6055,NAPA,2018,19,978,953,1931
6055,NAPA,2018,20,929,1038,1967
6055,NAPA,2018,21,950,997,1947
6055,NAPA,2018,22,910,1040,1950
6055,NAPA,2018,23,968,936,1904
6055,NAPA,2018,24,967,1034,2001
6055,NAPA,2018,25,917,1041,1958
6055,NAPA,2018,26,934,1023,1957
6055,NAPA,2018,27,895,1012,1907
6055,NAPA,2018,28,855,1070,1925
6055,NAPA,2018,29,835,1033,1868
6055,NAPA,2018,30,769,975,1744
6055,NAPA,2018,31,877,903,1780
6055,NAPA,2018,32,868,915,1783
6055,NAPA,2018,33,951,1046,1997
6055,NAPA,2018,34,847,1026,1873
6055,NAPA,2018,35,884,1013,1897
6055,NAPA,2018,36,880,957,1837
6055,NAPA,2018,37,833,863,1696
6055,NAPA,2018,38,820,972,1792
6055,NAPA,2018,39,833,926,1759
6055,NAPA,2018,40,778,824,1602
6055,NAPA,2018,41,793,806,1599
6055,NAPA,2018,42,798,801,1599
6055,NAPA,2018,43,781,840,1621
6055,NAPA,2018,44,805,834,1639
6055,NAPA,2018,45,840,892,1732
6055,NAPA,2018,46,843,844,1687
6055,NAPA,2018,47,869,881,1750
6055,NAPA,2018,48,941,943,1884
6055,NAPA,2018,49,934,919,1853
6055,NAPA,2018,50,936,845,1781
6055,NAPA,2018,51,870,936,1806
6055,NAPA,2018,52,974,945,1919
6055,NAPA,2018,53,943,915,1858
6055,NAPA,2018,54,1038,971,2009
6055,NAPA,2018,55,985,1006,1991
6055,NAPA,2018,56,1035,957,1992
6055,NAPA,2018,57,1060,980,2040
6055,NAPA,2018,58,1125,1059,2184
6055,NAPA,2018,59,1002,935,1937
6055,NAPA,2018,60,1029,932,1961
6055,NAPA,2018,61,1031,895,1926
6055,NAPA,2018,62,950,964,1914
6055,NAPA,2018,63,911,880,1791
6055,NAPA,2018,64,933,812,1745
6055,NAPA,2018,65,953,797,1750
6055,NAPA,2018,66,923,751,1674
6055,NAPA,2018,67,861,856,1717
6055,NAPA,2018,68,841,771,1612
6055,NAPA,2018,69,790,763,1553
6055,NAPA,2018,70,819,801,1620
6055,NAPA,2018,71,830,778,1608
6055,NAPA,2018,72,737,595,1332
6055,NAPA,2018,73,682,587,1269
6055,NAPA,2018,74,633,602,1235
6055,NAPA,2018,75,622,556,1178
6055,NAPA,2018,76,577,528,1105
6055,NAPA,2018,77,558,449,1007
6055,NAPA,2018,78,512,436,948
6055,NAPA,2018,79,434,364,798
6055,NAPA,2018,80,391,407,798
6055,NAPA,2018,81,382,300,682
6055,NAPA,2018,82,344,322,666
6055,NAPA,2018,83,351,274,625
6055,NAPA,2018,84,281,235,516
6055,NAPA,2018,85,297,238,535
6055,NAPA,2018,86,272,181,453
6055,NAPA,2018,87,276,166,442
6055,NAPA,2018,88,228,173,401
6055,NAPA,2018,89,214,106,320
6055,NAPA,2018,90,215,107,322
6055,NAPA,2018,91,162,69,231
6055,NAPA,2018,92,153,49,202
6055,NAPA,2018,93,116,40,156
6055,NAPA,2018,94,94,26,120
6055,NAPA,2018,95,80,16,96
6055,NAPA,2018,96,57,15,72
6055,NAPA,2018,97,47,7,54
6055,NAPA,2018,98,42,1,43
6055,NAPA,2018,99,22,1,23
6055,NAPA,2018,100,25,3,28
6055,NAPA,2019,0,704,782,1486
6055,NAPA,2019,1,729,747,1476
6055,NAPA,2019,2,658,736,1394
6055,NAPA,2019,3,701,755,1456
6055,NAPA,2019,4,686,767,1453
6055,NAPA,2019,5,737,749,1486
6055,NAPA,2019,6,706,714,1420
6055,NAPA,2019,7,723,823,1546
6055,NAPA,2019,8,711,799,1510
6055,NAPA,2019,9,743,803,1546
6055,NAPA,2019,10,860,784,1644
6055,NAPA,2019,11,765,867,1632
6055,NAPA,2019,12,834,900,1734
6055,NAPA,2019,13,870,944,1814
6055,NAPA,2019,14,877,912,1789
6055,NAPA,2019,15,853,949,1802
6055,NAPA,2019,16,1055,1003,2058
6055,NAPA,2019,17,855,905,1760
6055,NAPA,2019,18,946,918,1864
6055,NAPA,2019,19,963,960,1923
6055,NAPA,2019,20,969,971,1940
6055,NAPA,2019,21,914,1030,1944
6055,NAPA,2019,22,978,1024,2002
6055,NAPA,2019,23,915,1050,1965
6055,NAPA,2019,24,968,937,1905
6055,NAPA,2019,25,936,1026,1962
6055,NAPA,2019,26,939,1043,1982
6055,NAPA,2019,27,949,1054,2003
6055,NAPA,2019,28,911,1043,1954
6055,NAPA,2019,29,864,1081,1945
6055,NAPA,2019,30,840,1026,1866
6055,NAPA,2019,31,774,986,1760
6055,NAPA,2019,32,884,911,1795
6055,NAPA,2019,33,879,924,1803
6055,NAPA,2019,34,960,1053,2013
6055,NAPA,2019,35,851,1031,1882
6055,NAPA,2019,36,873,1001,1874
6055,NAPA,2019,37,872,956,1828
6055,NAPA,2019,38,822,868,1690
6055,NAPA,2019,39,823,962,1785
6055,NAPA,2019,40,823,924,1747
6055,NAPA,2019,41,777,834,1611
6055,NAPA,2019,42,796,808,1604
6055,NAPA,2019,43,812,799,1611
6055,NAPA,2019,44,783,839,1622
6055,NAPA,2019,45,818,857,1675
6055,NAPA,2019,46,829,873,1702
6055,NAPA,2019,47,840,818,1658
6055,NAPA,2019,48,868,889,1757
6055,NAPA,2019,49,925,931,1856
6055,NAPA,2019,50,929,907,1836
6055,NAPA,2019,51,953,862,1815
6055,NAPA,2019,52,892,935,1827
6055,NAPA,2019,53,996,927,1923
6055,NAPA,2019,54,950,930,1880
6055,NAPA,2019,55,1045,955,2000
6055,NAPA,2019,56,975,984,1959
6055,NAPA,2019,57,1026,960,1986
6055,NAPA,2019,58,1050,960,2010
6055,NAPA,2019,59,1121,1060,2181
6055,NAPA,2019,60,997,925,1922
6055,NAPA,2019,61,1018,913,1931
6055,NAPA,2019,62,1030,882,1912
6055,NAPA,2019,63,927,955,1882
6055,NAPA,2019,64,911,859,1770
6055,NAPA,2019,65,929,807,1736
6055,NAPA,2019,66,932,784,1716
6055,NAPA,2019,67,914,736,1650
6055,NAPA,2019,68,852,848,1700
6055,NAPA,2019,69,839,745,1584
6055,NAPA,2019,70,771,753,1524
6055,NAPA,2019,71,820,791,1611
6055,NAPA,2019,72,829,766,1595
6055,NAPA,2019,73,728,594,1322
6055,NAPA,2019,74,671,575,1246
6055,NAPA,2019,75,638,635,1273
6055,NAPA,2019,76,597,520,1117
6055,NAPA,2019,77,572,517,1089
6055,NAPA,2019,78,541,435,976
6055,NAPA,2019,79,490,416,906
6055,NAPA,2019,80,426,373,799
6055,NAPA,2019,81,375,376,751
6055,NAPA,2019,82,358,275,633
6055,NAPA,2019,83,328,315,643
6055,NAPA,2019,84,338,230,568
6055,NAPA,2019,85,296,223,519
6055,NAPA,2019,86,282,204,486
6055,NAPA,2019,87,249,161,410
6055,NAPA,2019,88,256,167,423
6055,NAPA,2019,89,206,140,346
6055,NAPA,2019,90,187,101,288
6055,NAPA,2019,91,176,78,254
6055,NAPA,2019,92,130,57,187
6055,NAPA,2019,93,135,41,176
6055,NAPA,2019,94,101,28,129
6055,NAPA,2019,95,70,12,82
6055,NAPA,2019,96,57,14,71
6055,NAPA,2019,97,49,9,58
6055,NAPA,2019,98,32,3,35
6055,NAPA,2019,99,34,1,35
6055,NAPA,2019,100,35,2,37
6057,NEVADA,2017,0,376,441,817
6057,NEVADA,2017,1,403,397,800
6057,NEVADA,2017,2,426,404,830
6057,NEVADA,2017,3,412,449,861
6057,NEVADA,2017,4,367,422,789
6057,NEVADA,2017,5,360,404,764
6057,NEVADA,2017,6,383,396,779
6057,NEVADA,2017,7,402,403,805
6057,NEVADA,2017,8,420,455,875
6057,NEVADA,2017,9,433,482,915
6057,NEVADA,2017,10,429,470,899
6057,NEVADA,2017,11,459,491,950
6057,NEVADA,2017,12,506,476,982
6057,NEVADA,2017,13,455,462,917
6057,NEVADA,2017,14,493,514,1007
6057,NEVADA,2017,15,487,542,1029
6057,NEVADA,2017,16,514,539,1053
6057,NEVADA,2017,17,564,581,1145
6057,NEVADA,2017,18,530,614,1144
6057,NEVADA,2017,19,575,627,1202
6057,NEVADA,2017,20,555,657,1212
6057,NEVADA,2017,21,602,694,1296
6057,NEVADA,2017,22,652,663,1315
6057,NEVADA,2017,23,653,654,1307
6057,NEVADA,2017,24,678,727,1405
6057,NEVADA,2017,25,575,683,1258
6057,NEVADA,2017,26,490,537,1027
6057,NEVADA,2017,27,427,512,939
6057,NEVADA,2017,28,421,490,911
6057,NEVADA,2017,29,391,453,844
6057,NEVADA,2017,30,435,472,907
6057,NEVADA,2017,31,445,497,942
6057,NEVADA,2017,32,460,487,947
6057,NEVADA,2017,33,448,515,963
6057,NEVADA,2017,34,473,521,994
6057,NEVADA,2017,35,452,513,965
6057,NEVADA,2017,36,422,502,924
6057,NEVADA,2017,37,454,525,979
6057,NEVADA,2017,38,459,530,989
6057,NEVADA,2017,39,477,512,989
6057,NEVADA,2017,40,476,486,962
6057,NEVADA,2017,41,486,462,948
6057,NEVADA,2017,42,480,490,970
6057,NEVADA,2017,43,411,478,889
6057,NEVADA,2017,44,439,516,955
6057,NEVADA,2017,45,450,509,959
6057,NEVADA,2017,46,570,544,1114
6057,NEVADA,2017,47,611,620,1231
6057,NEVADA,2017,48,590,579,1169
6057,NEVADA,2017,49,533,530,1063
6057,NEVADA,2017,50,565,576,1141
6057,NEVADA,2017,51,572,544,1116
6057,NEVADA,2017,52,653,618,1271
6057,NEVADA,2017,53,696,645,1341
6057,NEVADA,2017,54,756,656,1412
6057,NEVADA,2017,55,745,663,1408
6057,NEVADA,2017,56,810,692,1502
6057,NEVADA,2017,57,877,752,1629
6057,NEVADA,2017,58,855,710,1565
6057,NEVADA,2017,59,902,738,1640
6057,NEVADA,2017,60,882,819,1701
6057,NEVADA,2017,61,895,761,1656
6057,NEVADA,2017,62,911,816,1727
6057,NEVADA,2017,63,948,830,1778
6057,NEVADA,2017,64,908,768,1676
6057,NEVADA,2017,65,908,795,1703
6057,NEVADA,2017,66,934,821,1755
6057,NEVADA,2017,67,876,892,1768
6057,NEVADA,2017,68,909,892,1801
6057,NEVADA,2017,69,909,881,1790
6057,NEVADA,2017,70,898,872,1770
6057,NEVADA,2017,71,750,733,1483
6057,NEVADA,2017,72,680,625,1305
6057,NEVADA,2017,73,660,568,1228
6057,NEVADA,2017,74,589,588,1177
6057,NEVADA,2017,75,600,507,1107
6057,NEVADA,2017,76,485,464,949
6057,NEVADA,2017,77,452,402,854
6057,NEVADA,2017,78,478,393,871
6057,NEVADA,2017,79,367,390,757
6057,NEVADA,2017,80,331,315,646
6057,NEVADA,2017,81,323,307,630
6057,NEVADA,2017,82,294,275,569
6057,NEVADA,2017,83,261,241,502
6057,NEVADA,2017,84,246,189,435
6057,NEVADA,2017,85,292,205,497
6057,NEVADA,2017,86,263,196,459
6057,NEVADA,2017,87,251,167,418
6057,NEVADA,2017,88,194,143,337
6057,NEVADA,2017,89,192,132,324
6057,NEVADA,2017,90,210,110,320
6057,NEVADA,2017,91,164,85,249
6057,NEVADA,2017,92,112,54,166
6057,NEVADA,2017,93,81,45,126
6057,NEVADA,2017,94,61,41,102
6057,NEVADA,2017,95,54,33,87
6057,NEVADA,2017,96,48,17,65
6057,NEVADA,2017,97,17,16,33
6057,NEVADA,2017,98,19,5,24
6057,NEVADA,2017,99,10,3,13
6057,NEVADA,2017,100,23,5,28
6057,NEVADA,2018,0,375,450,825
6057,NEVADA,2018,1,375,440,815
6057,NEVADA,2018,2,406,399,805
6057,NEVADA,2018,3,425,405,830
6057,NEVADA,2018,4,413,450,863
6057,NEVADA,2018,5,366,420,786
6057,NEVADA,2018,6,367,411,778
6057,NEVADA,2018,7,387,401,788
6057,NEVADA,2018,8,406,405,811
6057,NEVADA,2018,9,424,455,879
6057,NEVADA,2018,10,435,492,927
6057,NEVADA,2018,11,429,473,902
6057,NEVADA,2018,12,463,498,961
6057,NEVADA,2018,13,506,474,980
6057,NEVADA,2018,14,455,475,930
6057,NEVADA,2018,15,497,517,1014
6057,NEVADA,2018,16,485,548,1033
6057,NEVADA,2018,17,522,550,1072
6057,NEVADA,2018,18,567,600,1167
6057,NEVADA,2018,19,536,612,1148
6057,NEVADA,2018,20,582,640,1222
6057,NEVADA,2018,21,572,672,1244
6057,NEVADA,2018,22,602,687,1289
6057,NEVADA,2018,23,659,674,1333
6057,NEVADA,2018,24,653,677,1330
6057,NEVADA,2018,25,676,732,1408
6057,NEVADA,2018,26,585,686,1271
6057,NEVADA,2018,27,494,548,1042
6057,NEVADA,2018,28,429,509,938
6057,NEVADA,2018,29,423,487,910
6057,NEVADA,2018,30,398,469,867
6057,NEVADA,2018,31,438,458,896
6057,NEVADA,2018,32,449,502,951
6057,NEVADA,2018,33,466,492,958
6057,NEVADA,2018,34,445,512,957
6057,NEVADA,2018,35,478,522,1000
6057,NEVADA,2018,36,457,519,976
6057,NEVADA,2018,37,426,507,933
6057,NEVADA,2018,38,460,526,986
6057,NEVADA,2018,39,456,527,983
6057,NEVADA,2018,40,486,520,1006
6057,NEVADA,2018,41,481,485,966
6057,NEVADA,2018,42,489,461,950
6057,NEVADA,2018,43,489,500,989
6057,NEVADA,2018,44,417,483,900
6057,NEVADA,2018,45,447,520,967
6057,NEVADA,2018,46,456,514,970
6057,NEVADA,2018,47,585,542,1127
6057,NEVADA,2018,48,616,628,1244
6057,NEVADA,2018,49,596,574,1170
6057,NEVADA,2018,50,533,531,1064
6057,NEVADA,2018,51,564,575,1139
6057,NEVADA,2018,52,570,543,1113
6057,NEVADA,2018,53,653,614,1267
6057,NEVADA,2018,54,698,644,1342
6057,NEVADA,2018,55,754,648,1402
6057,NEVADA,2018,56,743,658,1401
6057,NEVADA,2018,57,804,693,1497
6057,NEVADA,2018,58,879,752,1631
6057,NEVADA,2018,59,851,702,1553
6057,NEVADA,2018,60,896,730,1626
6057,NEVADA,2018,61,878,820,1698
6057,NEVADA,2018,62,886,750,1636
6057,NEVADA,2018,63,909,799,1708
6057,NEVADA,2018,64,942,827,1769
6057,NEVADA,2018,65,894,758,1652
6057,NEVADA,2018,66,908,795,1703
6057,NEVADA,2018,67,942,833,1775
6057,NEVADA,2018,68,871,882,1753
6057,NEVADA,2018,69,916,898,1814
6057,NEVADA,2018,70,919,869,1788
6057,NEVADA,2018,71,880,859,1739
6057,NEVADA,2018,72,737,702,1439
6057,NEVADA,2018,73,671,611,1282
6057,NEVADA,2018,74,647,561,1208
6057,NEVADA,2018,75,587,572,1159
6057,NEVADA,2018,76,582,491,1073
6057,NEVADA,2018,77,480,443,923
6057,NEVADA,2018,78,436,388,824
6057,NEVADA,2018,79,464,374,838
6057,NEVADA,2018,80,360,385,745
6057,NEVADA,2018,81,318,303,621
6057,NEVADA,2018,82,310,291,601
6057,NEVADA,2018,83,288,251,539
6057,NEVADA,2018,84,249,231,480
6057,NEVADA,2018,85,254,179,433
6057,NEVADA,2018,86,277,196,473
6057,NEVADA,2018,87,241,176,417
6057,NEVADA,2018,88,231,161,392
6057,NEVADA,2018,89,183,130,313
6057,NEVADA,2018,90,173,117,290
6057,NEVADA,2018,91,173,88,261
6057,NEVADA,2018,92,136,69,205
6057,NEVADA,2018,93,85,40,125
6057,NEVADA,2018,94,74,34,108
6057,NEVADA,2018,95,52,32,84
6057,NEVADA,2018,96,37,22,59
6057,NEVADA,2018,97,38,13,51
6057,NEVADA,2018,98,11,12,23
6057,NEVADA,2018,99,10,2,12
6057,NEVADA,2018,100,20,6,26
6057,NEVADA,2019,0,410,432,842
6057,NEVADA,2019,1,373,449,822
6057,NEVADA,2019,2,378,441,819
6057,NEVADA,2019,3,405,401,806
6057,NEVADA,2019,4,425,406,831
6057,NEVADA,2019,5,414,448,862
6057,NEVADA,2019,6,370,423,793
6057,NEVADA,2019,7,376,414,790
6057,NEVADA,2019,8,395,404,799
6057,NEVADA,2019,9,408,404,812
6057,NEVADA,2019,10,430,466,896
6057,NEVADA,2019,11,436,494,930
6057,NEVADA,2019,12,433,481,914
6057,NEVADA,2019,13,463,497,960
6057,NEVADA,2019,14,509,483,992
6057,NEVADA,2019,15,465,476,941
6057,NEVADA,2019,16,494,525,1019
6057,NEVADA,2019,17,493,562,1055
6057,NEVADA,2019,18,521,572,1093
6057,NEVADA,2019,19,575,592,1167
6057,NEVADA,2019,20,540,632,1172
6057,NEVADA,2019,21,594,648,1242
6057,NEVADA,2019,22,573,663,1236
6057,NEVADA,2019,23,612,700,1312
6057,NEVADA,2019,24,661,704,1365
6057,NEVADA,2019,25,651,684,1335
6057,NEVADA,2019,26,687,727,1414
6057,NEVADA,2019,27,588,694,1282
6057,NEVADA,2019,28,505,546,1051
6057,NEVADA,2019,29,434,505,939
6057,NEVADA,2019,30,425,507,932
6057,NEVADA,2019,31,403,457,860
6057,NEVADA,2019,32,441,463,904
6057,NEVADA,2019,33,453,508,961
6057,NEVADA,2019,34,461,491,952
6057,NEVADA,2019,35,447,513,960
6057,NEVADA,2019,36,481,530,1011
6057,NEVADA,2019,37,465,527,992
6057,NEVADA,2019,38,431,511,942
6057,NEVADA,2019,39,457,524,981
6057,NEVADA,2019,40,463,535,998
6057,NEVADA,2019,41,492,518,1010
6057,NEVADA,2019,42,485,484,969
6057,NEVADA,2019,43,494,474,968
6057,NEVADA,2019,44,494,506,1000
6057,NEVADA,2019,45,422,493,915
6057,NEVADA,2019,46,450,527,977
6057,NEVADA,2019,47,467,509,976
6057,NEVADA,2019,48,591,549,1140
6057,NEVADA,2019,49,628,623,1251
6057,NEVADA,2019,50,596,580,1176
6057,NEVADA,2019,51,533,527,1060
6057,NEVADA,2019,52,561,572,1133
6057,NEVADA,2019,53,569,539,1108
6057,NEVADA,2019,54,653,612,1265
6057,NEVADA,2019,55,696,634,1330
6057,NEVADA,2019,56,753,647,1400
6057,NEVADA,2019,57,738,651,1389
6057,NEVADA,2019,58,808,690,1498
6057,NEVADA,2019,59,869,751,1620
6057,NEVADA,2019,60,849,690,1539
6057,NEVADA,2019,61,893,728,1621
6057,NEVADA,2019,62,869,805,1674
6057,NEVADA,2019,63,880,740,1620
6057,NEVADA,2019,64,901,792,1693
6057,NEVADA,2019,65,934,820,1754
6057,NEVADA,2019,66,896,757,1653
6057,NEVADA,2019,67,919,808,1727
6057,NEVADA,2019,68,948,830,1778
6057,NEVADA,2019,69,885,884,1769
6057,NEVADA,2019,70,923,897,1820
6057,NEVADA,2019,71,912,845,1757
6057,NEVADA,2019,72,862,836,1698
6057,NEVADA,2019,73,721,683,1404
6057,NEVADA,2019,74,660,600,1260
6057,NEVADA,2019,75,646,548,1194
6057,NEVADA,2019,76,570,554,1124
6057,NEVADA,2019,77,571,475,1046
6057,NEVADA,2019,78,475,428,903
6057,NEVADA,2019,79,412,375,787
6057,NEVADA,2019,80,462,359,821
6057,NEVADA,2019,81,351,366,717
6057,NEVADA,2019,82,306,286,592
6057,NEVADA,2019,83,310,267,577
6057,NEVADA,2019,84,275,242,517
6057,NEVADA,2019,85,258,225,483
6057,NEVADA,2019,86,244,171,415
6057,NEVADA,2019,87,258,177,435
6057,NEVADA,2019,88,224,168,392
6057,NEVADA,2019,89,207,151,358
6057,NEVADA,2019,90,168,117,285
6057,NEVADA,2019,91,145,104,249
6057,NEVADA,2019,92,144,69,213
6057,NEVADA,2019,93,111,56,167
6057,NEVADA,2019,94,77,37,114
6057,NEVADA,2019,95,62,26,88
6057,NEVADA,2019,96,39,22,61
6057,NEVADA,2019,97,28,18,46
6057,NEVADA,2019,98,33,9,42
6057,NEVADA,2019,99,5,7,12
6057,NEVADA,2019,100,19,5,24
6059,ORANGE,2017,0,17397,19508,36905
6059,ORANGE,2017,1,18184,18930,37114
6059,ORANGE,2017,2,18878,19901,38779
6059,ORANGE,2017,3,18752,19742,38494
6059,ORANGE,2017,4,18892,19683,38575
6059,ORANGE,2017,5,19069,20049,39118
6059,ORANGE,2017,6,19286,20512,39798
6059,ORANGE,2017,7,19073,19833,38906
6059,ORANGE,2017,8,19336,20185,39521
6059,ORANGE,2017,9,20036,21267,41303
6059,ORANGE,2017,10,20194,21684,41878
6059,ORANGE,2017,11,19929,21252,41181
6059,ORANGE,2017,12,20329,21458,41787
6059,ORANGE,2017,13,20525,21255,41780
6059,ORANGE,2017,14,20438,21339,41777
6059,ORANGE,2017,15,20411,21483,41894
6059,ORANGE,2017,16,20756,21721,42477
6059,ORANGE,2017,17,20631,22043,42674
6059,ORANGE,2017,18,24902,25692,50594
6059,ORANGE,2017,19,24506,25475,49981
6059,ORANGE,2017,20,24629,25743,50372
6059,ORANGE,2017,21,23969,25386,49355
6059,ORANGE,2017,22,23141,24764,47905
6059,ORANGE,2017,23,22892,24375,47267
6059,ORANGE,2017,24,22863,24281,47144
6059,ORANGE,2017,25,20799,22329,43128
6059,ORANGE,2017,26,18331,19336,37667
6059,ORANGE,2017,27,17761,18853,36614
6059,ORANGE,2017,28,17751,18761,36512
6059,ORANGE,2017,29,17377,18623,36000
6059,ORANGE,2017,30,17808,19233,37041
6059,ORANGE,2017,31,18589,19977,38566
6059,ORANGE,2017,32,19958,21281,41239
6059,ORANGE,2017,33,20681,21995,42676
6059,ORANGE,2017,34,21158,22471,43629
6059,ORANGE,2017,35,21168,22069,43237
6059,ORANGE,2017,36,20872,21365,42237
6059,ORANGE,2017,37,20449,21230,41679
6059,ORANGE,2017,38,19393,19827,39220
6059,ORANGE,2017,39,18854,19701,38555
6059,ORANGE,2017,40,19276,19232,38508
6059,ORANGE,2017,41,20089,19910,39999
6059,ORANGE,2017,42,21250,20911,42161
6059,ORANGE,2017,43,21335,20802,42137
6059,ORANGE,2017,44,21659,20958,42617
6059,ORANGE,2017,45,22565,22491,45056
6059,ORANGE,2017,46,24320,23681,48001
6059,ORANGE,2017,47,25087,24679,49766
6059,ORANGE,2017,48,24210,23430,47640
6059,ORANGE,2017,49,23453,22735,46188
6059,ORANGE,2017,50,22784,22459,45243
6059,ORANGE,2017,51,22499,21939,44438
6059,ORANGE,2017,52,23101,22826,45927
6059,ORANGE,2017,53,23151,22687,45838
6059,ORANGE,2017,54,22822,22255,45077
6059,ORANGE,2017,55,22737,21751,44488
6059,ORANGE,2017,56,22695,22083,44778
6059,ORANGE,2017,57,22736,22174,44910
6059,ORANGE,2017,58,21365,20474,41839
6059,ORANGE,2017,59,20980,20405,41385
6059,ORANGE,2017,60,20176,19530,39706
6059,ORANGE,2017,61,19857,18679,38536
6059,ORANGE,2017,62,19245,17846,37091
6059,ORANGE,2017,63,18159,16621,34780
6059,ORANGE,2017,64,17260,15947,33207
6059,ORANGE,2017,65,16370,14801,31171
6059,ORANGE,2017,66,15706,13917,29623
6059,ORANGE,2017,67,15607,13984,29591
6059,ORANGE,2017,68,15246,13729,28975
6059,ORANGE,2017,69,15179,13360,28539
6059,ORANGE,2017,70,15377,13226,28603
6059,ORANGE,2017,71,12686,11064,23750
6059,ORANGE,2017,72,12033,10382,22415
6059,ORANGE,2017,73,11420,9916,21336
6059,ORANGE,2017,74,11390,9612,21002
6059,ORANGE,2017,75,10333,8430,18763
6059,ORANGE,2017,76,9383,7616,16999
6059,ORANGE,2017,77,8555,7402,15957
6059,ORANGE,2017,78,8112,6448,14560
6059,ORANGE,2017,79,7822,6294,14116
6059,ORANGE,2017,80,7618,5709,13327
6059,ORANGE,2017,81,7019,5355,12374
6059,ORANGE,2017,82,6835,4890,11725
6059,ORANGE,2017,83,6059,4355,10414
6059,ORANGE,2017,84,5783,3978,9761
6059,ORANGE,2017,85,6009,4028,10037
6059,ORANGE,2017,86,5645,3555,9200
6059,ORANGE,2017,87,4958,3101,8059
6059,ORANGE,2017,88,4367,2685,7052
6059,ORANGE,2017,89,3968,2244,6212
6059,ORANGE,2017,90,3727,1834,5561
6059,ORANGE,2017,91,3161,1648,4809
6059,ORANGE,2017,92,2361,1285,3646
6059,ORANGE,2017,93,1829,892,2721
6059,ORANGE,2017,94,1596,734,2330
6059,ORANGE,2017,95,1319,471,1790
6059,ORANGE,2017,96,849,369,1218
6059,ORANGE,2017,97,614,194,808
6059,ORANGE,2017,98,303,131,434
6059,ORANGE,2017,99,188,67,255
6059,ORANGE,2017,100,257,110,367
6059,ORANGE,2018,0,17318,19076,36394
6059,ORANGE,2018,1,17329,19444,36773
6059,ORANGE,2018,2,18355,19144,37499
6059,ORANGE,2018,3,19034,20066,39100
6059,ORANGE,2018,4,18900,19881,38781
6059,ORANGE,2018,5,19002,19826,38828
6059,ORANGE,2018,6,19237,20196,39433
6059,ORANGE,2018,7,19384,20627,40011
6059,ORANGE,2018,8,19171,19955,39126
6059,ORANGE,2018,9,19445,20271,39716
6059,ORANGE,2018,10,20170,21375,41545
6059,ORANGE,2018,11,20300,21871,42171
6059,ORANGE,2018,12,20083,21438,41521
6059,ORANGE,2018,13,20431,21599,42030
6059,ORANGE,2018,14,20647,21398,42045
6059,ORANGE,2018,15,20700,21584,42284
6059,ORANGE,2018,16,20070,21128,41198
6059,ORANGE,2018,17,20667,21559,42226
6059,ORANGE,2018,18,24834,26159,50993
6059,ORANGE,2018,19,24783,25798,50581
6059,ORANGE,2018,20,23978,24945,48923
6059,ORANGE,2018,21,23887,25054,48941
6059,ORANGE,2018,22,23680,25139,48819
6059,ORANGE,2018,23,22501,23973,46474
6059,ORANGE,2018,24,22344,23857,46201
6059,ORANGE,2018,25,22023,23473,45496
6059,ORANGE,2018,26,19604,21044,40648
6059,ORANGE,2018,27,18412,19433,37845
6059,ORANGE,2018,28,17858,18934,36792
6059,ORANGE,2018,29,17730,18757,36487
6059,ORANGE,2018,30,17465,18664,36129
6059,ORANGE,2018,31,17757,19119,36876
6059,ORANGE,2018,32,18516,19937,38453
6059,ORANGE,2018,33,19931,21153,41084
6059,ORANGE,2018,34,20575,21915,42490
6059,ORANGE,2018,35,21172,22378,43550
6059,ORANGE,2018,36,21036,21965,43001
6059,ORANGE,2018,37,20921,21436,42357
6059,ORANGE,2018,38,20480,21300,41780
6059,ORANGE,2018,39,19424,19918,39342
6059,ORANGE,2018,40,18914,19690,38604
6059,ORANGE,2018,41,19448,19388,38836
6059,ORANGE,2018,42,20251,20048,40299
6059,ORANGE,2018,43,21408,21096,42504
6059,ORANGE,2018,44,21469,20990,42459
6059,ORANGE,2018,45,21812,21137,42949
6059,ORANGE,2018,46,22529,22468,44997
6059,ORANGE,2018,47,24305,23652,47957
6059,ORANGE,2018,48,25094,24592,49686
6059,ORANGE,2018,49,24208,23409,47617
6059,ORANGE,2018,50,23432,22671,46103
6059,ORANGE,2018,51,22669,22312,44981
6059,ORANGE,2018,52,22414,21847,44261
6059,ORANGE,2018,53,23033,22694,45727
6059,ORANGE,2018,54,23089,22554,45643
6059,ORANGE,2018,55,22738,22148,44886
6059,ORANGE,2018,56,22576,21522,44098
6059,ORANGE,2018,57,22547,21889,44436
6059,ORANGE,2018,58,22553,21913,44466
6059,ORANGE,2018,59,21223,20290,41513
6059,ORANGE,2018,60,20842,20199,41041
6059,ORANGE,2018,61,19988,19284,39272
6059,ORANGE,2018,62,19645,18438,38083
6059,ORANGE,2018,63,19067,17615,36682
6059,ORANGE,2018,64,17996,16393,34389
6059,ORANGE,2018,65,17118,15741,32859
6059,ORANGE,2018,66,16265,14679,30944
6059,ORANGE,2018,67,15603,13795,29398
6059,ORANGE,2018,68,15502,13842,29344
6059,ORANGE,2018,69,15129,13567,28696
6059,ORANGE,2018,70,15118,13207,28325
6059,ORANGE,2018,71,15202,13009,28211
6059,ORANGE,2018,72,12523,10814,23337
6059,ORANGE,2018,73,11886,10187,22073
6059,ORANGE,2018,74,11277,9688,20965
6059,ORANGE,2018,75,11298,9499,20797
6059,ORANGE,2018,76,10106,8155,18261
6059,ORANGE,2018,77,9234,7392,16626
6059,ORANGE,2018,78,8381,7192,15573
6059,ORANGE,2018,79,7959,6260,14219
6059,ORANGE,2018,80,7879,6143,14022
6059,ORANGE,2018,81,7284,5352,12636
6059,ORANGE,2018,82,6749,5071,11820
6059,ORANGE,2018,83,6546,4618,11164
6059,ORANGE,2018,84,5854,4094,9948
6059,ORANGE,2018,85,5998,3904,9902
6059,ORANGE,2018,86,5473,3659,9132
6059,ORANGE,2018,87,5212,3255,8467
6059,ORANGE,2018,88,4529,2848,7377
6059,ORANGE,2018,89,4045,2404,6449
6059,ORANGE,2018,90,3625,2050,5675
6059,ORANGE,2018,91,3147,1492,4639
6059,ORANGE,2018,92,2666,1321,3987
6059,ORANGE,2018,93,2008,1038,3046
6059,ORANGE,2018,94,1553,730,2283
6059,ORANGE,2018,95,1375,587,1962
6059,ORANGE,2018,96,965,328,1293
6059,ORANGE,2018,97,638,277,915
6059,ORANGE,2018,98,485,137,622
6059,ORANGE,2018,99,213,92,305
6059,ORANGE,2018,100,283,111,394
6059,ORANGE,2019,0,17141,18973,36114
6059,ORANGE,2019,1,17252,19022,36274
6059,ORANGE,2019,2,17520,19644,37164
6059,ORANGE,2019,3,18505,19342,37847
6059,ORANGE,2019,4,19189,20229,39418
6059,ORANGE,2019,5,19010,20013,39023
6059,ORANGE,2019,6,19160,19958,39118
6059,ORANGE,2019,7,19326,20326,39652
6059,ORANGE,2019,8,19492,20740,40232
6059,ORANGE,2019,9,19285,20062,39347
6059,ORANGE,2019,10,19595,20393,39988
6059,ORANGE,2019,11,20288,21571,41859
6059,ORANGE,2019,12,20458,22072,42530
6059,ORANGE,2019,13,20204,21541,41745
6059,ORANGE,2019,14,20562,21758,42320
6059,ORANGE,2019,15,20912,21653,42565
6059,ORANGE,2019,16,20371,21201,41572
6059,ORANGE,2019,17,20035,20985,41020
6059,ORANGE,2019,18,24894,25723,50617
6059,ORANGE,2019,19,24682,26286,50968
6059,ORANGE,2019,20,24285,25310,49595
6059,ORANGE,2019,21,23235,24257,47492
6059,ORANGE,2019,22,23600,24790,48390
6059,ORANGE,2019,23,23038,24353,47391
6059,ORANGE,2019,24,21957,23464,45421
6059,ORANGE,2019,25,21501,23062,44563
6059,ORANGE,2019,26,20857,22209,43066
6059,ORANGE,2019,27,19673,21143,40816
6059,ORANGE,2019,28,18514,19508,38022
6059,ORANGE,2019,29,17857,18908,36765
6059,ORANGE,2019,30,17817,18795,36612
6059,ORANGE,2019,31,17410,18552,35962
6059,ORANGE,2019,32,17680,19079,36759
6059,ORANGE,2019,33,18486,19797,38283
6059,ORANGE,2019,34,19815,21081,40896
6059,ORANGE,2019,35,20596,21835,42431
6059,ORANGE,2019,36,21044,22298,43342
6059,ORANGE,2019,37,21102,22022,43124
6059,ORANGE,2019,38,20947,21472,42419
6059,ORANGE,2019,39,20508,21397,41905
6059,ORANGE,2019,40,19462,19934,39396
6059,ORANGE,2019,41,19096,19829,38925
6059,ORANGE,2019,42,19613,19558,39171
6059,ORANGE,2019,43,20442,20240,40682
6059,ORANGE,2019,44,21523,21289,42812
6059,ORANGE,2019,45,21627,21177,42804
6059,ORANGE,2019,46,21787,21115,42902
6059,ORANGE,2019,47,22517,22448,44965
6059,ORANGE,2019,48,24310,23573,47883
6059,ORANGE,2019,49,25078,24571,49649
6059,ORANGE,2019,50,24198,23349,47547
6059,ORANGE,2019,51,23324,22541,45865
6059,ORANGE,2019,52,22583,22238,44821
6059,ORANGE,2019,53,22363,21717,44080
6059,ORANGE,2019,54,22984,22559,45543
6059,ORANGE,2019,55,23002,22454,45456
6059,ORANGE,2019,56,22570,21940,44510
6059,ORANGE,2019,57,22462,21357,43819
6059,ORANGE,2019,58,22366,21632,43998
6059,ORANGE,2019,59,22413,21748,44161
6059,ORANGE,2019,60,21103,20068,41171
6059,ORANGE,2019,61,20692,19951,40643
6059,ORANGE,2019,62,19808,19056,38864
6059,ORANGE,2019,63,19491,18205,37696
6059,ORANGE,2019,64,18897,17372,36269
6059,ORANGE,2019,65,17861,16175,34036
6059,ORANGE,2019,66,17037,15588,32625
6059,ORANGE,2019,67,16169,14588,30757
6059,ORANGE,2019,68,15525,13654,29179
6059,ORANGE,2019,69,15412,13679,29091
6059,ORANGE,2019,70,15096,13441,28537
6059,ORANGE,2019,71,14913,12954,27867
6059,ORANGE,2019,72,14998,12731,27729
6059,ORANGE,2019,73,12383,10641,23024
6059,ORANGE,2019,74,11727,9966,21693
6059,ORANGE,2019,75,11212,9584,20796
6059,ORANGE,2019,76,11054,9215,20269
6059,ORANGE,2019,77,9895,7921,17816
6059,ORANGE,2019,78,9050,7186,16236
6059,ORANGE,2019,79,8238,7027,15265
6059,ORANGE,2019,80,8006,6126,14132
6059,ORANGE,2019,81,7545,5818,13363
6059,ORANGE,2019,82,7030,5067,12097
6059,ORANGE,2019,83,6482,4800,11282
6059,ORANGE,2019,84,6339,4373,10712
6059,ORANGE,2019,85,6081,4057,10138
6059,ORANGE,2019,86,5511,3535,9046
6059,ORANGE,2019,87,5058,3333,8391
6059,ORANGE,2019,88,4768,3007,7775
6059,ORANGE,2019,89,4172,2548,6720
6059,ORANGE,2019,90,3732,2179,5911
6059,ORANGE,2019,91,3064,1666,4730
6059,ORANGE,2019,92,2625,1241,3866
6059,ORANGE,2019,93,2259,1084,3343
6059,ORANGE,2019,94,1699,853,2552
6059,ORANGE,2019,95,1335,585,1920
6059,ORANGE,2019,96,1042,401,1443
6059,ORANGE,2019,97,752,243,995
6059,ORANGE,2019,98,475,210,685
6059,ORANGE,2019,99,351,100,451
6059,ORANGE,2019,100,325,134,459
6061,PLACER,2017,0,1841,1951,3792
6061,PLACER,2017,1,1832,1882,3714
6061,PLACER,2017,2,1743,1877,3620
6061,PLACER,2017,3,1793,1925,3718
6061,PLACER,2017,4,1852,1864,3716
6061,PLACER,2017,5,1807,1899,3706
6061,PLACER,2017,6,1876,2038,3914
6061,PLACER,2017,7,1977,1928,3905
6061,PLACER,2017,8,1973,2109,4082
6061,PLACER,2017,9,2093,2187,4280
6061,PLACER,2017,10,2162,2260,4422
6061,PLACER,2017,11,2244,2414,4658
6061,PLACER,2017,12,2302,2413,4715
6061,PLACER,2017,13,2333,2588,4921
6061,PLACER,2017,14,2435,2528,4963
6061,PLACER,2017,15,2514,2572,5086
6061,PLACER,2017,16,2320,2585,4905
6061,PLACER,2017,17,2400,2486,4886
6061,PLACER,2017,18,2408,2524,4932
6061,PLACER,2017,19,2205,2364,4569
6061,PLACER,2017,20,2213,2258,4471
6061,PLACER,2017,21,2207,2281,4488
6061,PLACER,2017,22,2012,2107,4119
6061,PLACER,2017,23,2060,2145,4205
6061,PLACER,2017,24,2215,2212,4427
6061,PLACER,2017,25,1899,2101,4000
6061,PLACER,2017,26,1938,2125,4063
6061,PLACER,2017,27,1898,2264,4162
6061,PLACER,2017,28,2074,2302,4376
6061,PLACER,2017,29,2054,2322,4376
6061,PLACER,2017,30,2177,2491,4668
6061,PLACER,2017,31,2512,2433,4945
6061,PLACER,2017,32,2645,2776,5421
6061,PLACER,2017,33,2643,2675,5318
6061,PLACER,2017,34,2622,2633,5255
6061,PLACER,2017,35,2477,2655,5132
6061,PLACER,2017,36,2488,2549,5037
6061,PLACER,2017,37,2446,2474,4920
6061,PLACER,2017,38,2259,2443,4702
6061,PLACER,2017,39,2279,2374,4653
6061,PLACER,2017,40,2266,2454,4720
6061,PLACER,2017,41,2285,2306,4591
6061,PLACER,2017,42,2330,2289,4619
6061,PLACER,2017,43,2224,2346,4570
6061,PLACER,2017,44,2382,2329,4711
6061,PLACER,2017,45,2419,2350,4769
6061,PLACER,2017,46,2614,2437,5051
6061,PLACER,2017,47,2783,2676,5459
6061,PLACER,2017,48,2637,2343,4980
6061,PLACER,2017,49,2546,2319,4865
6061,PLACER,2017,50,2420,2333,4753
6061,PLACER,2017,51,2484,2329,4813
6061,PLACER,2017,52,2584,2603,5187
6061,PLACER,2017,53,2754,2547,5301
6061,PLACER,2017,54,2711,2639,5350
6061,PLACER,2017,55,2801,2575,5376
6061,PLACER,2017,56,2887,2696,5583
6061,PLACER,2017,57,2854,2734,5588
6061,PLACER,2017,58,2813,2598,5411
6061,PLACER,2017,59,2714,2507,5221
6061,PLACER,2017,60,2724,2473,5197
6061,PLACER,2017,61,2646,2358,5004
6061,PLACER,2017,62,2607,2368,4975
6061,PLACER,2017,63,2511,2353,4864
6061,PLACER,2017,64,2582,2304,4886
6061,PLACER,2017,65,2397,2194,4591
6061,PLACER,2017,66,2401,2214,4615
6061,PLACER,2017,67,2445,2106,4551
6061,PLACER,2017,68,2393,2062,4455
6061,PLACER,2017,69,2425,2122,4547
6061,PLACER,2017,70,2478,2184,4662
6061,PLACER,2017,71,2133,1806,3939
6061,PLACER,2017,72,2013,1746,3759
6061,PLACER,2017,73,2021,1574,3595
6061,PLACER,2017,74,1974,1636,3610
6061,PLACER,2017,75,1700,1548,3248
6061,PLACER,2017,76,1664,1247,2911
6061,PLACER,2017,77,1511,1262,2773
6061,PLACER,2017,78,1434,1147,2581
6061,PLACER,2017,79,1274,1103,2377
6061,PLACER,2017,80,1326,982,2308
6061,PLACER,2017,81,1129,894,2023
6061,PLACER,2017,82,1079,813,1892
6061,PLACER,2017,83,1005,755,1760
6061,PLACER,2017,84,914,724,1638
6061,PLACER,2017,85,950,587,1537
6061,PLACER,2017,86,899,618,1517
6061,PLACER,2017,87,755,474,1229
6061,PLACER,2017,88,695,476,1171
6061,PLACER,2017,89,603,376,979
6061,PLACER,2017,90,502,315,817
6061,PLACER,2017,91,537,239,776
6061,PLACER,2017,92,371,185,556
6061,PLACER,2017,93,306,126,432
6061,PLACER,2017,94,214,112,326
6061,PLACER,2017,95,178,69,247
6061,PLACER,2017,96,141,65,206
6061,PLACER,2017,97,79,43,122
6061,PLACER,2017,98,46,13,59
6061,PLACER,2017,99,27,4,31
6061,PLACER,2017,100,47,3,50
6061,PLACER,2018,0,1756,2079,3835
6061,PLACER,2018,1,1833,1944,3777
6061,PLACER,2018,2,1839,1897,3736
6061,PLACER,2018,3,1747,1872,3619
6061,PLACER,2018,4,1807,1934,3741
6061,PLACER,2018,5,1853,1873,3726
6061,PLACER,2018,6,1826,1916,3742
6061,PLACER,2018,7,1888,2045,3933
6061,PLACER,2018,8,1984,1949,3933
6061,PLACER,2018,9,1982,2133,4115
6061,PLACER,2018,10,2099,2219,4318
6061,PLACER,2018,11,2174,2285,4459
6061,PLACER,2018,12,2256,2440,4696
6061,PLACER,2018,13,2323,2464,4787
6061,PLACER,2018,14,2365,2601,4966
6061,PLACER,2018,15,2473,2547,5020
6061,PLACER,2018,16,2428,2496,4924
6061,PLACER,2018,17,2270,2549,4819
6061,PLACER,2018,18,2382,2486,4868
6061,PLACER,2018,19,2374,2477,4851
6061,PLACER,2018,20,2119,2227,4346
6061,PLACER,2018,21,2202,2250,4452
6061,PLACER,2018,22,2183,2266,4449
6061,PLACER,2018,23,2014,2095,4109
6061,PLACER,2018,24,2030,2135,4165
6061,PLACER,2018,25,2185,2171,4356
6061,PLACER,2018,26,2072,2255,4327
6061,PLACER,2018,27,2106,2327,4433
6061,PLACER,2018,28,2042,2385,4427
6061,PLACER,2018,29,2210,2482,4692
6061,PLACER,2018,30,2206,2442,4648
6061,PLACER,2018,31,2279,2567,4846
6061,PLACER,2018,32,2574,2493,5067
6061,PLACER,2018,33,2705,2856,5561
6061,PLACER,2018,34,2684,2727,5411
6061,PLACER,2018,35,2668,2703,5371
6061,PLACER,2018,36,2505,2727,5232
6061,PLACER,2018,37,2549,2619,5168
6061,PLACER,2018,38,2483,2567,5050
6061,PLACER,2018,39,2315,2512,4827
6061,PLACER,2018,40,2321,2461,4782
6061,PLACER,2018,41,2282,2494,4776
6061,PLACER,2018,42,2311,2298,4609
6061,PLACER,2018,43,2347,2312,4659
6061,PLACER,2018,44,2246,2348,4594
6061,PLACER,2018,45,2385,2351,4736
6061,PLACER,2018,46,2417,2331,4748
6061,PLACER,2018,47,2606,2437,5043
6061,PLACER,2018,48,2778,2663,5441
6061,PLACER,2018,49,2633,2335,4968
6061,PLACER,2018,50,2523,2307,4830
6061,PLACER,2018,51,2435,2334,4769
6061,PLACER,2018,52,2499,2325,4824
6061,PLACER,2018,53,2592,2621,5213
6061,PLACER,2018,54,2766,2542,5308
6061,PLACER,2018,55,2709,2640,5349
6061,PLACER,2018,56,2802,2561,5363
6061,PLACER,2018,57,2901,2685,5586
6061,PLACER,2018,58,2856,2727,5583
6061,PLACER,2018,59,2819,2605,5424
6061,PLACER,2018,60,2729,2487,5216
6061,PLACER,2018,61,2767,2466,5233
6061,PLACER,2018,62,2662,2383,5045
6061,PLACER,2018,63,2616,2419,5035
6061,PLACER,2018,64,2549,2347,4896
6061,PLACER,2018,65,2598,2296,4894
6061,PLACER,2018,66,2419,2219,4638
6061,PLACER,2018,67,2397,2179,4576
6061,PLACER,2018,68,2477,2091,4568
6061,PLACER,2018,69,2411,2068,4479
6061,PLACER,2018,70,2468,2130,4598
6061,PLACER,2018,71,2529,2169,4698
6061,PLACER,2018,72,2140,1803,3943
6061,PLACER,2018,73,1997,1718,3715
6061,PLACER,2018,74,2016,1582,3598
6061,PLACER,2018,75,1986,1622,3608
6061,PLACER,2018,76,1675,1520,3195
6061,PLACER,2018,77,1635,1242,2877
6061,PLACER,2018,78,1501,1225,2726
6061,PLACER,2018,79,1420,1132,2552
6061,PLACER,2018,80,1265,1065,2330
6061,PLACER,2018,81,1301,919,2220
6061,PLACER,2018,82,1083,858,1941
6061,PLACER,2018,83,1036,772,1808
6061,PLACER,2018,84,970,728,1698
6061,PLACER,2018,85,942,709,1651
6061,PLACER,2018,86,917,554,1471
6061,PLACER,2018,87,813,564,1377
6061,PLACER,2018,88,702,423,1125
6061,PLACER,2018,89,619,428,1047
6061,PLACER,2018,90,550,331,881
6061,PLACER,2018,91,463,265,728
6061,PLACER,2018,92,448,200,648
6061,PLACER,2018,93,293,150,443
6061,PLACER,2018,94,267,98,365
6061,PLACER,2018,95,180,87,267
6061,PLACER,2018,96,133,48,181
6061,PLACER,2018,97,106,41,147
6061,PLACER,2018,98,59,32,91
6061,PLACER,2018,99,37,8,45
6061,PLACER,2018,100,42,4,46
6061,PLACER,2019,0,1842,2073,3915
6061,PLACER,2019,1,1747,2076,3823
6061,PLACER,2019,2,1842,1964,3806
6061,PLACER,2019,3,1843,1894,3737
6061,PLACER,2019,4,1760,1875,3635
6061,PLACER,2019,5,1810,1943,3753
6061,PLACER,2019,6,1873,1887,3760
6061,PLACER,2019,7,1843,1925,3768
6061,PLACER,2019,8,1892,2062,3954
6061,PLACER,2019,9,1997,1972,3969
6061,PLACER,2019,10,1998,2157,4155
6061,PLACER,2019,11,2118,2249,4367
6061,PLACER,2019,12,2207,2310,4517
6061,PLACER,2019,13,2270,2476,4746
6061,PLACER,2019,14,2359,2481,4840
6061,PLACER,2019,15,2394,2623,5017
6061,PLACER,2019,16,2412,2486,4898
6061,PLACER,2019,17,2367,2451,4818
6061,PLACER,2019,18,2253,2546,4799
6061,PLACER,2019,19,2350,2450,4800
6061,PLACER,2019,20,2278,2341,4619
6061,PLACER,2019,21,2111,2218,4329
6061,PLACER,2019,22,2179,2236,4415
6061,PLACER,2019,23,2184,2251,4435
6061,PLACER,2019,24,1987,2088,4075
6061,PLACER,2019,25,1993,2103,4096
6061,PLACER,2019,26,2346,2341,4687
6061,PLACER,2019,27,2231,2451,4682
6061,PLACER,2019,28,2270,2456,4726
6061,PLACER,2019,29,2183,2588,4771
6061,PLACER,2019,30,2359,2618,4977
6061,PLACER,2019,31,2303,2535,4838
6061,PLACER,2019,32,2343,2626,4969
6061,PLACER,2019,33,2645,2572,5217
6061,PLACER,2019,34,2745,2915,5660
6061,PLACER,2019,35,2736,2797,5533
6061,PLACER,2019,36,2703,2767,5470
6061,PLACER,2019,37,2578,2804,5382
6061,PLACER,2019,38,2594,2719,5313
6061,PLACER,2019,39,2539,2636,5175
6061,PLACER,2019,40,2356,2583,4939
6061,PLACER,2019,41,2331,2497,4828
6061,PLACER,2019,42,2305,2486,4791
6061,PLACER,2019,43,2329,2321,4650
6061,PLACER,2019,44,2374,2319,4693
6061,PLACER,2019,45,2249,2376,4625
6061,PLACER,2019,46,2375,2327,4702
6061,PLACER,2019,47,2409,2332,4741
6061,PLACER,2019,48,2610,2425,5035
6061,PLACER,2019,49,2770,2657,5427
6061,PLACER,2019,50,2613,2319,4932
6061,PLACER,2019,51,2525,2318,4843
6061,PLACER,2019,52,2446,2330,4776
6061,PLACER,2019,53,2506,2329,4835
6061,PLACER,2019,54,2609,2611,5220
6061,PLACER,2019,55,2767,2547,5314
6061,PLACER,2019,56,2708,2629,5337
6061,PLACER,2019,57,2802,2566,5368
6061,PLACER,2019,58,2918,2681,5599
6061,PLACER,2019,59,2871,2737,5608
6061,PLACER,2019,60,2833,2590,5423
6061,PLACER,2019,61,2745,2482,5227
6061,PLACER,2019,62,2782,2489,5271
6061,PLACER,2019,63,2661,2439,5100
6061,PLACER,2019,64,2666,2419,5085
6061,PLACER,2019,65,2577,2339,4916
6061,PLACER,2019,66,2629,2324,4953
6061,PLACER,2019,67,2417,2214,4631
6061,PLACER,2019,68,2414,2167,4581
6061,PLACER,2019,69,2493,2093,4586
6061,PLACER,2019,70,2437,2072,4509
6061,PLACER,2019,71,2515,2140,4655
6061,PLACER,2019,72,2541,2164,4705
6061,PLACER,2019,73,2124,1783,3907
6061,PLACER,2019,74,2001,1715,3716
6061,PLACER,2019,75,2017,1566,3583
6061,PLACER,2019,76,1965,1591,3556
6061,PLACER,2019,77,1645,1504,3149
6061,PLACER,2019,78,1618,1218,2836
6061,PLACER,2019,79,1488,1190,2678
6061,PLACER,2019,80,1429,1111,2540
6061,PLACER,2019,81,1238,1017,2255
6061,PLACER,2019,82,1255,894,2149
6061,PLACER,2019,83,1042,827,1869
6061,PLACER,2019,84,996,708,1704
6061,PLACER,2019,85,994,714,1708
6061,PLACER,2019,86,905,660,1565
6061,PLACER,2019,87,838,493,1331
6061,PLACER,2019,88,757,516,1273
6061,PLACER,2019,89,636,369,1005
6061,PLACER,2019,90,564,373,937
6061,PLACER,2019,91,529,271,800
6061,PLACER,2019,92,402,226,628
6061,PLACER,2019,93,361,156,517
6061,PLACER,2019,94,242,121,363
6061,PLACER,2019,95,227,83,310
6061,PLACER,2019,96,141,65,206
6061,PLACER,2019,97,99,32,131
6061,PLACER,2019,98,77,19,96
6061,PLACER,2019,99,40,26,66
6061,PLACER,2019,100,57,8,65
6063,PLUMAS,2017,0,74,90,164
6063,PLUMAS,2017,1,78,91,169
6063,PLUMAS,2017,2,87,64,151
6063,PLUMAS,2017,3,76,80,156
6063,PLUMAS,2017,4,69,76,145
6063,PLUMAS,2017,5,71,81,152
6063,PLUMAS,2017,6,76,90,166
6063,PLUMAS,2017,7,88,83,171
6063,PLUMAS,2017,8,85,101,186
6063,PLUMAS,2017,9,86,88,174
6063,PLUMAS,2017,10,84,96,180
6063,PLUMAS,2017,11,87,84,171
6063,PLUMAS,2017,12,110,105,215
6063,PLUMAS,2017,13,99,94,193
6063,PLUMAS,2017,14,105,93,198
6063,PLUMAS,2017,15,90,84,174
6063,PLUMAS,2017,16,89,98,187
6063,PLUMAS,2017,17,106,116,222
6063,PLUMAS,2017,18,93,118,211
6063,PLUMAS,2017,19,129,135,264
6063,PLUMAS,2017,20,91,109,200
6063,PLUMAS,2017,21,108,122,230
6063,PLUMAS,2017,22,121,115,236
6063,PLUMAS,2017,23,113,138,251
6063,PLUMAS,2017,24,110,108,218
6063,PLUMAS,2017,25,120,131,251
6063,PLUMAS,2017,26,132,130,262
6063,PLUMAS,2017,27,95,144,239
6063,PLUMAS,2017,28,90,101,191
6063,PLUMAS,2017,29,88,86,174
6063,PLUMAS,2017,30,82,63,145
6063,PLUMAS,2017,31,65,82,147
6063,PLUMAS,2017,32,76,85,161
6063,PLUMAS,2017,33,78,93,171
6063,PLUMAS,2017,34,72,97,169
6063,PLUMAS,2017,35,79,92,171
6063,PLUMAS,2017,36,91,82,173
6063,PLUMAS,2017,37,85,90,175
6063,PLUMAS,2017,38,77,92,169
6063,PLUMAS,2017,39,97,77,174
6063,PLUMAS,2017,40,93,72,165
6063,PLUMAS,2017,41,75,79,154
6063,PLUMAS,2017,42,68,89,157
6063,PLUMAS,2017,43,72,88,160
6063,PLUMAS,2017,44,77,71,148
6063,PLUMAS,2017,45,98,95,193
6063,PLUMAS,2017,46,87,89,176
6063,PLUMAS,2017,47,102,85,187
6063,PLUMAS,2017,48,91,100,191
6063,PLUMAS,2017,49,97,91,188
6063,PLUMAS,2017,50,109,100,209
6063,PLUMAS,2017,51,111,109,220
6063,PLUMAS,2017,52,118,103,221
6063,PLUMAS,2017,53,114,145,259
6063,PLUMAS,2017,54,150,126,276
6063,PLUMAS,2017,55,156,120,276
6063,PLUMAS,2017,56,159,160,319
6063,PLUMAS,2017,57,158,153,311
6063,PLUMAS,2017,58,169,137,306
6063,PLUMAS,2017,59,203,157,360
6063,PLUMAS,2017,60,184,199,383
6063,PLUMAS,2017,61,191,147,338
6063,PLUMAS,2017,62,200,155,355
6063,PLUMAS,2017,63,189,176,365
6063,PLUMAS,2017,64,191,174,365
6063,PLUMAS,2017,65,185,211,396
6063,PLUMAS,2017,66,200,177,377
6063,PLUMAS,2017,67,154,199,353
6063,PLUMAS,2017,68,161,183,344
6063,PLUMAS,2017,69,205,189,394
6063,PLUMAS,2017,70,192,184,376
6063,PLUMAS,2017,71,158,149,307
6063,PLUMAS,2017,72,140,137,277
6063,PLUMAS,2017,73,141,145,286
6063,PLUMAS,2017,74,134,145,279
6063,PLUMAS,2017,75,106,127,233
6063,PLUMAS,2017,76,111,114,225
6063,PLUMAS,2017,77,102,101,203
6063,PLUMAS,2017,78,96,94,190
6063,PLUMAS,2017,79,91,96,187
6063,PLUMAS,2017,80,81,66,147
6063,PLUMAS,2017,81,63,80,143
6063,PLUMAS,2017,82,66,66,132
6063,PLUMAS,2017,83,57,45,102
6063,PLUMAS,2017,84,64,46,110
6063,PLUMAS,2017,85,43,30,73
6063,PLUMAS,2017,86,41,51,92
6063,PLUMAS,2017,87,43,38,81
6063,PLUMAS,2017,88,41,24,65
6063,PLUMAS,2017,89,28,29,57
6063,PLUMAS,2017,90,23,19,42
6063,PLUMAS,2017,91,29,15,44
6063,PLUMAS,2017,92,12,10,22
6063,PLUMAS,2017,93,18,2,20
6063,PLUMAS,2017,94,5,7,12
6063,PLUMAS,2017,95,11,0,11
6063,PLUMAS,2017,96,3,1,4
6063,PLUMAS,2017,97,7,1,8
6063,PLUMAS,2017,99,0,2,2
6063,PLUMAS,2017,100,2,0,2
6063,PLUMAS,2018,0,75,101,176
6063,PLUMAS,2018,1,74,89,163
6063,PLUMAS,2018,2,78,92,170
6063,PLUMAS,2018,3,87,64,151
6063,PLUMAS,2018,4,76,80,156
6063,PLUMAS,2018,5,69,76,145
6063,PLUMAS,2018,6,71,82,153
6063,PLUMAS,2018,7,76,90,166
6063,PLUMAS,2018,8,90,83,173
6063,PLUMAS,2018,9,85,101,186
6063,PLUMAS,2018,10,86,88,174
6063,PLUMAS,2018,11,84,97,181
6063,PLUMAS,2018,12,87,84,171
6063,PLUMAS,2018,13,110,105,215
6063,PLUMAS,2018,14,99,94,193
6063,PLUMAS,2018,15,111,97,208
6063,PLUMAS,2018,16,86,88,174
6063,PLUMAS,2018,17,96,102,198
6063,PLUMAS,2018,18,114,130,244
6063,PLUMAS,2018,19,91,109,200
6063,PLUMAS,2018,20,119,127,246
6063,PLUMAS,2018,21,97,109,206
6063,PLUMAS,2018,22,102,123,225
6063,PLUMAS,2018,23,121,111,232
6063,PLUMAS,2018,24,112,142,254
6063,PLUMAS,2018,25,111,101,212
6063,PLUMAS,2018,26,122,132,254
6063,PLUMAS,2018,27,130,129,259
6063,PLUMAS,2018,28,97,145,242
6063,PLUMAS,2018,29,93,101,194
6063,PLUMAS,2018,30,87,84,171
6063,PLUMAS,2018,31,82,64,146
6063,PLUMAS,2018,32,65,81,146
6063,PLUMAS,2018,33,77,86,163
6063,PLUMAS,2018,34,79,94,173
6063,PLUMAS,2018,35,72,95,167
6063,PLUMAS,2018,36,79,93,172
6063,PLUMAS,2018,37,92,80,172
6063,PLUMAS,2018,38,87,92,179
6063,PLUMAS,2018,39,76,90,166
6063,PLUMAS,2018,40,97,77,174
6063,PLUMAS,2018,41,94,72,166
6063,PLUMAS,2018,42,75,79,154
6063,PLUMAS,2018,43,68,91,159
6063,PLUMAS,2018,44,72,91,163
6063,PLUMAS,2018,45,77,70,147
6063,PLUMAS,2018,46,98,93,191
6063,PLUMAS,2018,47,86,88,174
6063,PLUMAS,2018,48,102,86,188
6063,PLUMAS,2018,49,91,102,193
6063,PLUMAS,2018,50,97,89,186
6063,PLUMAS,2018,51,109,98,207
6063,PLUMAS,2018,52,108,111,219
6063,PLUMAS,2018,53,119,102,221
6063,PLUMAS,2018,54,112,143,255
6063,PLUMAS,2018,55,150,125,275
6063,PLUMAS,2018,56,153,119,272
6063,PLUMAS,2018,57,156,162,318
6063,PLUMAS,2018,58,159,149,308
6063,PLUMAS,2018,59,166,139,305
6063,PLUMAS,2018,60,200,154,354
6063,PLUMAS,2018,61,184,195,379
6063,PLUMAS,2018,62,187,142,329
6063,PLUMAS,2018,63,199,153,352
6063,PLUMAS,2018,64,190,172,362
6063,PLUMAS,2018,65,187,175,362
6063,PLUMAS,2018,66,180,206,386
6063,PLUMAS,2018,67,200,174,374
6063,PLUMAS,2018,68,156,194,350
6063,PLUMAS,2018,69,158,178,336
6063,PLUMAS,2018,70,205,184,389
6063,PLUMAS,2018,71,187,181,368
6063,PLUMAS,2018,72,156,141,297
6063,PLUMAS,2018,73,138,134,272
6063,PLUMAS,2018,74,136,141,277
6063,PLUMAS,2018,75,137,142,279
6063,PLUMAS,2018,76,103,125,228
6063,PLUMAS,2018,77,106,110,216
6063,PLUMAS,2018,78,101,97,198
6063,PLUMAS,2018,79,85,92,177
6063,PLUMAS,2018,80,96,92,188
6063,PLUMAS,2018,81,73,61,134
6063,PLUMAS,2018,82,58,78,136
6063,PLUMAS,2018,83,65,58,123
6063,PLUMAS,2018,84,50,44,94
6063,PLUMAS,2018,85,66,48,114
6063,PLUMAS,2018,86,40,29,69
6063,PLUMAS,2018,87,39,44,83
6063,PLUMAS,2018,88,43,33,76
6063,PLUMAS,2018,89,34,21,55
6063,PLUMAS,2018,90,30,25,55
6063,PLUMAS,2018,91,17,13,30
6063,PLUMAS,2018,92,22,15,37
6063,PLUMAS,2018,93,12,7,19
6063,PLUMAS,2018,94,13,1,14
6063,PLUMAS,2018,95,4,4,8
6063,PLUMAS,2018,96,8,0,8
6063,PLUMAS,2018,97,2,1,3
6063,PLUMAS,2018,98,6,1,7
6063,PLUMAS,2018,100,1,2,3
6063,PLUMAS,2019,0,88,86,174
6063,PLUMAS,2019,1,75,101,176
6063,PLUMAS,2019,2,74,89,163
6063,PLUMAS,2019,3,78,93,171
6063,PLUMAS,2019,4,87,64,151
6063,PLUMAS,2019,5,76,80,156
6063,PLUMAS,2019,6,69,76,145
6063,PLUMAS,2019,7,71,82,153
6063,PLUMAS,2019,8,78,91,169
6063,PLUMAS,2019,9,90,83,173
6063,PLUMAS,2019,10,85,102,187
6063,PLUMAS,2019,11,86,88,174
6063,PLUMAS,2019,12,84,97,181
6063,PLUMAS,2019,13,87,85,172
6063,PLUMAS,2019,14,110,106,216
6063,PLUMAS,2019,15,104,96,200
6063,PLUMAS,2019,16,105,97,202
6063,PLUMAS,2019,17,93,90,183
6063,PLUMAS,2019,18,106,121,227
6063,PLUMAS,2019,19,116,124,240
6063,PLUMAS,2019,20,79,101,180
6063,PLUMAS,2019,21,124,128,252
6063,PLUMAS,2019,22,90,109,199
6063,PLUMAS,2019,23,102,119,221
6063,PLUMAS,2019,24,121,115,236
6063,PLUMAS,2019,25,113,134,247
6063,PLUMAS,2019,26,114,102,216
6063,PLUMAS,2019,27,119,132,251
6063,PLUMAS,2019,28,130,133,263
6063,PLUMAS,2019,29,100,145,245
6063,PLUMAS,2019,30,92,99,191
6063,PLUMAS,2019,31,87,85,172
6063,PLUMAS,2019,32,82,64,146
6063,PLUMAS,2019,33,66,83,149
6063,PLUMAS,2019,34,76,86,162
6063,PLUMAS,2019,35,80,93,173
6063,PLUMAS,2019,36,72,97,169
6063,PLUMAS,2019,37,81,90,171
6063,PLUMAS,2019,38,93,84,177
6063,PLUMAS,2019,39,86,90,176
6063,PLUMAS,2019,40,76,89,165
6063,PLUMAS,2019,41,98,77,175
6063,PLUMAS,2019,42,93,72,165
6063,PLUMAS,2019,43,76,80,156
6063,PLUMAS,2019,44,69,93,162
6063,PLUMAS,2019,45,72,90,162
6063,PLUMAS,2019,46,77,68,145
6063,PLUMAS,2019,47,97,92,189
6063,PLUMAS,2019,48,86,89,175
6063,PLUMAS,2019,49,102,88,190
6063,PLUMAS,2019,50,91,100,191
6063,PLUMAS,2019,51,97,87,184
6063,PLUMAS,2019,52,107,99,206
6063,PLUMAS,2019,53,109,110,219
6063,PLUMAS,2019,54,118,99,217
6063,PLUMAS,2019,55,111,140,251
6063,PLUMAS,2019,56,149,124,273
6063,PLUMAS,2019,57,152,121,273
6063,PLUMAS,2019,58,156,160,316
6063,PLUMAS,2019,59,158,151,309
6063,PLUMAS,2019,60,164,135,299
6063,PLUMAS,2019,61,201,154,355
6063,PLUMAS,2019,62,182,191,373
6063,PLUMAS,2019,63,187,140,327
6063,PLUMAS,2019,64,199,147,346
6063,PLUMAS,2019,65,188,172,360
6063,PLUMAS,2019,66,186,171,357
6063,PLUMAS,2019,67,177,206,383
6063,PLUMAS,2019,68,201,173,374
6063,PLUMAS,2019,69,152,188,340
6063,PLUMAS,2019,70,153,176,329
6063,PLUMAS,2019,71,199,182,381
6063,PLUMAS,2019,72,184,176,360
6063,PLUMAS,2019,73,154,138,292
6063,PLUMAS,2019,74,137,131,268
6063,PLUMAS,2019,75,138,137,275
6063,PLUMAS,2019,76,134,137,271
6063,PLUMAS,2019,77,100,122,222
6063,PLUMAS,2019,78,105,107,212
6063,PLUMAS,2019,79,94,97,191
6063,PLUMAS,2019,80,84,86,170
6063,PLUMAS,2019,81,90,83,173
6063,PLUMAS,2019,82,67,60,127
6063,PLUMAS,2019,83,59,67,126
6063,PLUMAS,2019,84,58,52,110
6063,PLUMAS,2019,85,49,45,94
6063,PLUMAS,2019,86,61,45,106
6063,PLUMAS,2019,87,36,22,58
6063,PLUMAS,2019,88,39,37,76
6063,PLUMAS,2019,89,35,30,65
6063,PLUMAS,2019,90,33,22,55
6063,PLUMAS,2019,91,20,18,38
6063,PLUMAS,2019,92,14,9,23
6063,PLUMAS,2019,93,20,14,34
6063,PLUMAS,2019,94,9,6,15
6063,PLUMAS,2019,95,11,0,11
6063,PLUMAS,2019,96,4,4,8
6063,PLUMAS,2019,97,7,0,7
6063,PLUMAS,2019,98,2,1,3
6063,PLUMAS,2019,99,5,0,5
6063,PLUMAS,2019,100,1,2,3
6065,RIVERSIDE,2017,0,14430,16077,30507
6065,RIVERSIDE,2017,1,14545,15471,30016
6065,RIVERSIDE,2017,2,14854,15966,30820
6065,RIVERSIDE,2017,3,15267,15959,31226
6065,RIVERSIDE,2017,4,15215,16041,31256
6065,RIVERSIDE,2017,5,15473,16133,31606
6065,RIVERSIDE,2017,6,15881,16974,32855
6065,RIVERSIDE,2017,7,15854,16471,32325
6065,RIVERSIDE,2017,8,16193,17026,33219
6065,RIVERSIDE,2017,9,17077,17882,34959
6065,RIVERSIDE,2017,10,17258,18057,35315
6065,RIVERSIDE,2017,11,17239,17723,34962
6065,RIVERSIDE,2017,12,16941,17398,34339
6065,RIVERSIDE,2017,13,16885,17858,34743
6065,RIVERSIDE,2017,14,16916,17602,34518
6065,RIVERSIDE,2017,15,17053,17648,34701
6065,RIVERSIDE,2017,16,17525,18074,35599
6065,RIVERSIDE,2017,17,17770,18242,36012
6065,RIVERSIDE,2017,18,19256,20141,39397
6065,RIVERSIDE,2017,19,19042,19782,38824
6065,RIVERSIDE,2017,20,18409,19429,37838
6065,RIVERSIDE,2017,21,18385,19405,37790
6065,RIVERSIDE,2017,22,17739,18866,36605
6065,RIVERSIDE,2017,23,17720,18847,36567
6065,RIVERSIDE,2017,24,17740,18728,36468
6065,RIVERSIDE,2017,25,16995,18307,35302
6065,RIVERSIDE,2017,26,16340,17746,34086
6065,RIVERSIDE,2017,27,16152,16694,32846
6065,RIVERSIDE,2017,28,15307,16446,31753
6065,RIVERSIDE,2017,29,14899,15875,30774
6065,RIVERSIDE,2017,30,14364,15648,30012
6065,RIVERSIDE,2017,31,14270,15479,29749
6065,RIVERSIDE,2017,32,14568,15207,29775
6065,RIVERSIDE,2017,33,14663,15180,29843
6065,RIVERSIDE,2017,34,14876,15180,30056
6065,RIVERSIDE,2017,35,14614,14907,29521
6065,RIVERSIDE,2017,36,14980,15006,29986
6065,RIVERSIDE,2017,37,14999,14701,29700
6065,RIVERSIDE,2017,38,14178,14199,28377
6065,RIVERSIDE,2017,39,14196,14088,28284
6065,RIVERSIDE,2017,40,14350,14285,28635
6065,RIVERSIDE,2017,41,14262,13864,28126
6065,RIVERSIDE,2017,42,14777,14523,29300
6065,RIVERSIDE,2017,43,14315,14132,28447
6065,RIVERSIDE,2017,44,14682,13949,28631
6065,RIVERSIDE,2017,45,14757,14621,29378
6065,RIVERSIDE,2017,46,15571,15142,30713
6065,RIVERSIDE,2017,47,15849,15826,31675
6065,RIVERSIDE,2017,48,15520,15566,31086
6065,RIVERSIDE,2017,49,15094,15047,30141
6065,RIVERSIDE,2017,50,14577,15015,29592
6065,RIVERSIDE,2017,51,14912,15142,30054
6065,RIVERSIDE,2017,52,15484,15819,31303
6065,RIVERSIDE,2017,53,15411,15326,30737
6065,RIVERSIDE,2017,54,15440,15206,30646
6065,RIVERSIDE,2017,55,14935,14768,29703
6065,RIVERSIDE,2017,56,15336,14917,30253
6065,RIVERSIDE,2017,57,15305,15013,30318
6065,RIVERSIDE,2017,58,14385,14221,28606
6065,RIVERSIDE,2017,59,14285,13735,28020
6065,RIVERSIDE,2017,60,14180,13365,27545
6065,RIVERSIDE,2017,61,13692,13247,26939
6065,RIVERSIDE,2017,62,13596,13021,26617
6065,RIVERSIDE,2017,63,12882,12040,24922
6065,RIVERSIDE,2017,64,12295,11147,23442
6065,RIVERSIDE,2017,65,11733,10679,22412
6065,RIVERSIDE,2017,66,11675,10388,22063
6065,RIVERSIDE,2017,67,11678,10042,21720
6065,RIVERSIDE,2017,68,11071,9740,20811
6065,RIVERSIDE,2017,69,11276,9788,21064
6065,RIVERSIDE,2017,70,11098,9846,20944
6065,RIVERSIDE,2017,71,9466,8213,17679
6065,RIVERSIDE,2017,72,9220,7722,16942
6065,RIVERSIDE,2017,73,8990,7406,16396
6065,RIVERSIDE,2017,74,8735,7207,15942
6065,RIVERSIDE,2017,75,8079,6690,14769
6065,RIVERSIDE,2017,76,7172,5835,13007
6065,RIVERSIDE,2017,77,6893,5661,12554
6065,RIVERSIDE,2017,78,6448,5129,11577
6065,RIVERSIDE,2017,79,5984,4981,10965
6065,RIVERSIDE,2017,80,5666,4608,10274
6065,RIVERSIDE,2017,81,5258,4210,9468
6065,RIVERSIDE,2017,82,4814,3814,8628
6065,RIVERSIDE,2017,83,4341,3429,7770
6065,RIVERSIDE,2017,84,4277,3253,7530
6065,RIVERSIDE,2017,85,4133,3046,7179
6065,RIVERSIDE,2017,86,3793,2777,6570
6065,RIVERSIDE,2017,87,3396,2357,5753
6065,RIVERSIDE,2017,88,2741,2076,4817
6065,RIVERSIDE,2017,89,2764,1688,4452
6065,RIVERSIDE,2017,90,2495,1461,3956
6065,RIVERSIDE,2017,91,2105,1100,3205
6065,RIVERSIDE,2017,92,1631,902,2533
6065,RIVERSIDE,2017,93,1291,762,2053
6065,RIVERSIDE,2017,94,1025,556,1581
6065,RIVERSIDE,2017,95,885,444,1329
6065,RIVERSIDE,2017,96,644,279,923
6065,RIVERSIDE,2017,97,367,176,543
6065,RIVERSIDE,2017,98,195,80,275
6065,RIVERSIDE,2017,99,141,61,202
6065,RIVERSIDE,2017,100,164,77,241
6065,RIVERSIDE,2018,0,14489,15981,30470
6065,RIVERSIDE,2018,1,14361,15998,30359
6065,RIVERSIDE,2018,2,14902,15939,30841
6065,RIVERSIDE,2018,3,15158,16336,31494
6065,RIVERSIDE,2018,4,15551,16375,31926
6065,RIVERSIDE,2018,5,15650,16334,31984
6065,RIVERSIDE,2018,6,15621,16281,31902
6065,RIVERSIDE,2018,7,16020,17092,33112
6065,RIVERSIDE,2018,8,15925,16543,32468
6065,RIVERSIDE,2018,9,16288,17175,33463
6065,RIVERSIDE,2018,10,17197,18014,35211
6065,RIVERSIDE,2018,11,17486,18189,35675
6065,RIVERSIDE,2018,12,17369,17996,35365
6065,RIVERSIDE,2018,13,17079,17538,34617
6065,RIVERSIDE,2018,14,17080,18022,35102
6065,RIVERSIDE,2018,15,17146,17833,34979
6065,RIVERSIDE,2018,16,17062,17643,34705
6065,RIVERSIDE,2018,17,17520,18066,35586
6065,RIVERSIDE,2018,18,19608,20240,39848
6065,RIVERSIDE,2018,19,19137,19833,38970
6065,RIVERSIDE,2018,20,18276,19459,37735
6065,RIVERSIDE,2018,21,18257,19087,37344
6065,RIVERSIDE,2018,22,18212,19253,37465
6065,RIVERSIDE,2018,23,17551,18631,36182
6065,RIVERSIDE,2018,24,17568,18605,36173
6065,RIVERSIDE,2018,25,17547,18782,36329
6065,RIVERSIDE,2018,26,16945,18212,35157
6065,RIVERSIDE,2018,27,16658,18010,34668
6065,RIVERSIDE,2018,28,16428,17040,33468
6065,RIVERSIDE,2018,29,15531,16739,32270
6065,RIVERSIDE,2018,30,15143,16144,31287
6065,RIVERSIDE,2018,31,14401,15696,30097
6065,RIVERSIDE,2018,32,14375,15505,29880
6065,RIVERSIDE,2018,33,14636,15331,29967
6065,RIVERSIDE,2018,34,14733,15249,29982
6065,RIVERSIDE,2018,35,14912,15224,30136
6065,RIVERSIDE,2018,36,14704,14964,29668
6065,RIVERSIDE,2018,37,15155,15207,30362
6065,RIVERSIDE,2018,38,15126,14888,30014
6065,RIVERSIDE,2018,39,14320,14441,28761
6065,RIVERSIDE,2018,40,14322,14288,28610
6065,RIVERSIDE,2018,41,14382,14227,28609
6065,RIVERSIDE,2018,42,14294,13962,28256
6065,RIVERSIDE,2018,43,14790,14493,29283
6065,RIVERSIDE,2018,44,14336,14177,28513
6065,RIVERSIDE,2018,45,14718,13964,28682
6065,RIVERSIDE,2018,46,14892,14724,29616
6065,RIVERSIDE,2018,47,15717,15306,31023
6065,RIVERSIDE,2018,48,15942,15925,31867
6065,RIVERSIDE,2018,49,15698,15696,31394
6065,RIVERSIDE,2018,50,15247,15073,30320
6065,RIVERSIDE,2018,51,14568,14970,29538
6065,RIVERSIDE,2018,52,14897,15132,30029
6065,RIVERSIDE,2018,53,15511,15777,31288
6065,RIVERSIDE,2018,54,15414,15282,30696
6065,RIVERSIDE,2018,55,15463,15068,30531
6065,RIVERSIDE,2018,56,15150,14778,29928
6065,RIVERSIDE,2018,57,15481,14975,30456
6065,RIVERSIDE,2018,58,15403,15028,30431
6065,RIVERSIDE,2018,59,14535,14274,28809
6065,RIVERSIDE,2018,60,14367,13736,28103
6065,RIVERSIDE,2018,61,14336,13480,27816
6065,RIVERSIDE,2018,62,13866,13375,27241
6065,RIVERSIDE,2018,63,13783,13092,26875
6065,RIVERSIDE,2018,64,13023,12062,25085
6065,RIVERSIDE,2018,65,12437,11195,23632
6065,RIVERSIDE,2018,66,11911,10779,22690
6065,RIVERSIDE,2018,67,11827,10413,22240
6065,RIVERSIDE,2018,68,11766,10035,21801
6065,RIVERSIDE,2018,69,11229,9838,21067
6065,RIVERSIDE,2018,70,11396,9769,21165
6065,RIVERSIDE,2018,71,11154,9800,20954
6065,RIVERSIDE,2018,72,9509,8072,17581
6065,RIVERSIDE,2018,73,9192,7609,16801
6065,RIVERSIDE,2018,74,8928,7357,16285
6065,RIVERSIDE,2018,75,8734,7221,15955
6065,RIVERSIDE,2018,76,7918,6490,14408
6065,RIVERSIDE,2018,77,7029,5675,12704
6065,RIVERSIDE,2018,78,6723,5479,12202
6065,RIVERSIDE,2018,79,6319,4972,11291
6065,RIVERSIDE,2018,80,5918,4902,10820
6065,RIVERSIDE,2018,81,5437,4319,9756
6065,RIVERSIDE,2018,82,5015,4001,9016
6065,RIVERSIDE,2018,83,4634,3641,8275
6065,RIVERSIDE,2018,84,4215,3242,7457
6065,RIVERSIDE,2018,85,4253,3102,7355
6065,RIVERSIDE,2018,86,3797,2745,6542
6065,RIVERSIDE,2018,87,3497,2520,6017
6065,RIVERSIDE,2018,88,3117,2162,5279
6065,RIVERSIDE,2018,89,2512,1864,4376
6065,RIVERSIDE,2018,90,2574,1524,4098
6065,RIVERSIDE,2018,91,2192,1204,3396
6065,RIVERSIDE,2018,92,1787,910,2697
6065,RIVERSIDE,2018,93,1404,735,2139
6065,RIVERSIDE,2018,94,1115,624,1739
6065,RIVERSIDE,2018,95,876,465,1341
6065,RIVERSIDE,2018,96,669,309,978
6065,RIVERSIDE,2018,97,512,198,710
6065,RIVERSIDE,2018,98,287,125,412
6065,RIVERSIDE,2018,99,145,64,209
6065,RIVERSIDE,2018,100,197,97,294
6065,RIVERSIDE,2019,0,14308,16228,30536
6065,RIVERSIDE,2019,1,14436,15917,30353
6065,RIVERSIDE,2019,2,14744,16525,31269
6065,RIVERSIDE,2019,3,15234,16346,31580
6065,RIVERSIDE,2019,4,15490,16712,32202
6065,RIVERSIDE,2019,5,15982,16665,32647
6065,RIVERSIDE,2019,6,15786,16475,32261
6065,RIVERSIDE,2019,7,15779,16405,32184
6065,RIVERSIDE,2019,8,16097,17162,33259
6065,RIVERSIDE,2019,9,16054,16693,32747
6065,RIVERSIDE,2019,10,16402,17328,33730
6065,RIVERSIDE,2019,11,17451,18176,35627
6065,RIVERSIDE,2019,12,17618,18474,36092
6065,RIVERSIDE,2019,13,17489,18151,35640
6065,RIVERSIDE,2019,14,17270,17748,35018
6065,RIVERSIDE,2019,15,17306,18239,35545
6065,RIVERSIDE,2019,16,17159,17853,35012
6065,RIVERSIDE,2019,17,17061,17651,34712
6065,RIVERSIDE,2019,18,19378,20040,39418
6065,RIVERSIDE,2019,19,19506,19926,39432
6065,RIVERSIDE,2019,20,18395,19520,37915
6065,RIVERSIDE,2019,21,18126,19105,37231
6065,RIVERSIDE,2019,22,18083,18940,37023
6065,RIVERSIDE,2019,23,18026,19020,37046
6065,RIVERSIDE,2019,24,17400,18388,35788
6065,RIVERSIDE,2019,25,17372,18652,36024
6065,RIVERSIDE,2019,26,17516,18701,36217
6065,RIVERSIDE,2019,27,17276,18483,35759
6065,RIVERSIDE,2019,28,16994,18371,35365
6065,RIVERSIDE,2019,29,16660,17338,33998
6065,RIVERSIDE,2019,30,15802,16999,32801
6065,RIVERSIDE,2019,31,15194,16183,31377
6065,RIVERSIDE,2019,32,14500,15727,30227
6065,RIVERSIDE,2019,33,14430,15629,30059
6065,RIVERSIDE,2019,34,14726,15394,30120
6065,RIVERSIDE,2019,35,14775,15310,30085
6065,RIVERSIDE,2019,36,15013,15284,30297
6065,RIVERSIDE,2019,37,14876,15127,30003
6065,RIVERSIDE,2019,38,15295,15400,30695
6065,RIVERSIDE,2019,39,15288,15141,30429
6065,RIVERSIDE,2019,40,14463,14668,29131
6065,RIVERSIDE,2019,41,14354,14240,28594
6065,RIVERSIDE,2019,42,14407,14330,28737
6065,RIVERSIDE,2019,43,14316,13934,28250
6065,RIVERSIDE,2019,44,14823,14556,29379
6065,RIVERSIDE,2019,45,14357,14193,28550
6065,RIVERSIDE,2019,46,14852,14085,28937
6065,RIVERSIDE,2019,47,15048,14897,29945
6065,RIVERSIDE,2019,48,15807,15407,31214
6065,RIVERSIDE,2019,49,16098,16074,32172
6065,RIVERSIDE,2019,50,15838,15791,31629
6065,RIVERSIDE,2019,51,15254,15015,30269
6065,RIVERSIDE,2019,52,14563,14975,29538
6065,RIVERSIDE,2019,53,14920,15081,30001
6065,RIVERSIDE,2019,54,15515,15732,31247
6065,RIVERSIDE,2019,55,15439,15158,30597
6065,RIVERSIDE,2019,56,15708,15100,30808
6065,RIVERSIDE,2019,57,15336,14845,30181
6065,RIVERSIDE,2019,58,15550,15015,30565
6065,RIVERSIDE,2019,59,15596,15052,30648
6065,RIVERSIDE,2019,60,14643,14280,28923
6065,RIVERSIDE,2019,61,14507,13907,28414
6065,RIVERSIDE,2019,62,14518,13639,28157
6065,RIVERSIDE,2019,63,14032,13421,27453
6065,RIVERSIDE,2019,64,13940,13121,27061
6065,RIVERSIDE,2019,65,13163,12107,25270
6065,RIVERSIDE,2019,66,12649,11308,23957
6065,RIVERSIDE,2019,67,12060,10792,22852
6065,RIVERSIDE,2019,68,11953,10471,22424
6065,RIVERSIDE,2019,69,11913,10144,22057
6065,RIVERSIDE,2019,70,11324,9828,21152
6065,RIVERSIDE,2019,71,11487,9718,21205
6065,RIVERSIDE,2019,72,11174,9709,20883
6065,RIVERSIDE,2019,73,9503,7921,17424
6065,RIVERSIDE,2019,74,9134,7555,16689
6065,RIVERSIDE,2019,75,8933,7364,16297
6065,RIVERSIDE,2019,76,8591,7006,15597
6065,RIVERSIDE,2019,77,7798,6347,14145
6065,RIVERSIDE,2019,78,6873,5483,12356
6065,RIVERSIDE,2019,79,6566,5311,11877
6065,RIVERSIDE,2019,80,6245,4900,11145
6065,RIVERSIDE,2019,81,5666,4659,10325
6065,RIVERSIDE,2019,82,5197,4117,9314
6065,RIVERSIDE,2019,83,4862,3784,8646
6065,RIVERSIDE,2019,84,4430,3468,7898
6065,RIVERSIDE,2019,85,4220,3069,7289
6065,RIVERSIDE,2019,86,3906,2810,6716
6065,RIVERSIDE,2019,87,3515,2482,5997
6065,RIVERSIDE,2019,88,3219,2319,5538
6065,RIVERSIDE,2019,89,2867,1942,4809
6065,RIVERSIDE,2019,90,2342,1721,4063
6065,RIVERSIDE,2019,91,2274,1250,3524
6065,RIVERSIDE,2019,92,1842,990,2832
6065,RIVERSIDE,2019,93,1549,759,2308
6065,RIVERSIDE,2019,94,1212,613,1825
6065,RIVERSIDE,2019,95,947,512,1459
6065,RIVERSIDE,2019,96,682,338,1020
6065,RIVERSIDE,2019,97,520,239,759
6065,RIVERSIDE,2019,98,387,134,521
6065,RIVERSIDE,2019,99,226,89,315
6065,RIVERSIDE,2019,100,242,102,344
6067,SACRAMENTO,2017,0,9079,10361,19440
6067,SACRAMENTO,2017,1,9474,10007,19481
6067,SACRAMENTO,2017,2,9745,9961,19706
6067,SACRAMENTO,2017,3,9660,10086,19746
6067,SACRAMENTO,2017,4,9560,9984,19544
6067,SACRAMENTO,2017,5,9627,10159,19786
6067,SACRAMENTO,2017,6,9989,10463,20452
6067,SACRAMENTO,2017,7,9514,10164,19678
6067,SACRAMENTO,2017,8,9759,10129,19888
6067,SACRAMENTO,2017,9,10122,10595,20717
6067,SACRAMENTO,2017,10,10214,10526,20740
6067,SACRAMENTO,2017,11,10110,10721,20831
6067,SACRAMENTO,2017,12,10092,10547,20639
6067,SACRAMENTO,2017,13,9973,10347,20320
6067,SACRAMENTO,2017,14,9935,10180,20115
6067,SACRAMENTO,2017,15,9893,10397,20290
6067,SACRAMENTO,2017,16,9925,10518,20443
6067,SACRAMENTO,2017,17,10051,10544,20595
6067,SACRAMENTO,2017,18,11339,11957,23296
6067,SACRAMENTO,2017,19,11876,12423,24299
6067,SACRAMENTO,2017,20,12236,13115,25351
6067,SACRAMENTO,2017,21,12047,12953,25000
6067,SACRAMENTO,2017,22,11928,12964,24892
6067,SACRAMENTO,2017,23,11942,12586,24528
6067,SACRAMENTO,2017,24,11721,12355,24076
6067,SACRAMENTO,2017,25,10789,11460,22249
6067,SACRAMENTO,2017,26,9030,9528,18558
6067,SACRAMENTO,2017,27,8487,8952,17439
6067,SACRAMENTO,2017,28,8612,8778,17390
6067,SACRAMENTO,2017,29,9155,9306,18461
6067,SACRAMENTO,2017,30,9793,9713,19506
6067,SACRAMENTO,2017,31,9912,9967,19879
6067,SACRAMENTO,2017,32,10371,10523,20894
6067,SACRAMENTO,2017,33,10748,10537,21285
6067,SACRAMENTO,2017,34,10983,10735,21718
6067,SACRAMENTO,2017,35,11171,11021,22192
6067,SACRAMENTO,2017,36,10848,10754,21602
6067,SACRAMENTO,2017,37,10737,10975,21712
6067,SACRAMENTO,2017,38,10524,10242,20766
6067,SACRAMENTO,2017,39,9970,10086,20056
6067,SACRAMENTO,2017,40,9874,9974,19848
6067,SACRAMENTO,2017,41,9684,9594,19278
6067,SACRAMENTO,2017,42,9814,9513,19327
6067,SACRAMENTO,2017,43,9497,9335,18832
6067,SACRAMENTO,2017,44,9614,9603,19217
6067,SACRAMENTO,2017,45,9842,9724,19566
6067,SACRAMENTO,2017,46,10268,9843,20111
6067,SACRAMENTO,2017,47,10605,10507,21112
6067,SACRAMENTO,2017,48,9866,9779,19645
6067,SACRAMENTO,2017,49,9418,9578,18996
6067,SACRAMENTO,2017,50,9421,9183,18604
6067,SACRAMENTO,2017,51,9433,9238,18671
6067,SACRAMENTO,2017,52,10053,9731,19784
6067,SACRAMENTO,2017,53,10305,9776,20081
6067,SACRAMENTO,2017,54,10236,9841,20077
6067,SACRAMENTO,2017,55,10083,9738,19821
6067,SACRAMENTO,2017,56,10408,9724,20132
6067,SACRAMENTO,2017,57,10591,9748,20339
6067,SACRAMENTO,2017,58,10035,9073,19108
6067,SACRAMENTO,2017,59,9915,8952,18867
6067,SACRAMENTO,2017,60,9783,8671,18454
6067,SACRAMENTO,2017,61,9573,8265,17838
6067,SACRAMENTO,2017,62,9475,8278,17753
6067,SACRAMENTO,2017,63,8937,7862,16799
6067,SACRAMENTO,2017,64,8597,7374,15971
6067,SACRAMENTO,2017,65,8386,7042,15428
6067,SACRAMENTO,2017,66,7882,6489,14371
6067,SACRAMENTO,2017,67,7906,6743,14649
6067,SACRAMENTO,2017,68,7659,6432,14091
6067,SACRAMENTO,2017,69,7368,6209,13577
6067,SACRAMENTO,2017,70,7297,6006,13303
6067,SACRAMENTO,2017,71,5743,4815,10558
6067,SACRAMENTO,2017,72,5292,4264,9556
6067,SACRAMENTO,2017,73,5057,3908,8965
6067,SACRAMENTO,2017,74,4883,3964,8847
6067,SACRAMENTO,2017,75,4495,3306,7801
6067,SACRAMENTO,2017,76,4104,3092,7196
6067,SACRAMENTO,2017,77,3907,2886,6793
6067,SACRAMENTO,2017,78,3544,2669,6213
6067,SACRAMENTO,2017,79,3486,2527,6013
6067,SACRAMENTO,2017,80,3303,2393,5696
6067,SACRAMENTO,2017,81,3155,2130,5285
6067,SACRAMENTO,2017,82,2795,1989,4784
6067,SACRAMENTO,2017,83,2632,1733,4365
6067,SACRAMENTO,2017,84,2519,1675,4194
6067,SACRAMENTO,2017,85,2485,1697,4182
6067,SACRAMENTO,2017,86,2273,1486,3759
6067,SACRAMENTO,2017,87,2134,1310,3444
6067,SACRAMENTO,2017,88,1696,1037,2733
6067,SACRAMENTO,2017,89,1742,951,2693
6067,SACRAMENTO,2017,90,1614,808,2422
6067,SACRAMENTO,2017,91,1359,677,2036
6067,SACRAMENTO,2017,92,1075,463,1538
6067,SACRAMENTO,2017,93,792,349,1141
6067,SACRAMENTO,2017,94,725,282,1007
6067,SACRAMENTO,2017,95,534,243,777
6067,SACRAMENTO,2017,96,379,144,523
6067,SACRAMENTO,2017,97,248,81,329
6067,SACRAMENTO,2017,98,147,37,184
6067,SACRAMENTO,2017,99,105,28,133
6067,SACRAMENTO,2017,100,121,26,147
6067,SACRAMENTO,2018,0,9261,10230,19491
6067,SACRAMENTO,2018,1,9032,10308,19340
6067,SACRAMENTO,2018,2,9535,10095,19630
6067,SACRAMENTO,2018,3,9825,10005,19830
6067,SACRAMENTO,2018,4,9703,10157,19860
6067,SACRAMENTO,2018,5,9595,10045,19640
6067,SACRAMENTO,2018,6,9637,10175,19812
6067,SACRAMENTO,2018,7,9998,10477,20475
6067,SACRAMENTO,2018,8,9532,10177,19709
6067,SACRAMENTO,2018,9,9778,10141,19919
6067,SACRAMENTO,2018,10,10145,10627,20772
6067,SACRAMENTO,2018,11,10327,10658,20985
6067,SACRAMENTO,2018,12,10214,10812,21026
6067,SACRAMENTO,2018,13,10211,10681,20892
6067,SACRAMENTO,2018,14,10049,10452,20501
6067,SACRAMENTO,2018,15,10075,10316,20391
6067,SACRAMENTO,2018,16,9906,10440,20346
6067,SACRAMENTO,2018,17,10095,10711,20806
6067,SACRAMENTO,2018,18,11376,12036,23412
6067,SACRAMENTO,2018,19,11946,12497,24443
6067,SACRAMENTO,2018,20,12123,12904,25027
6067,SACRAMENTO,2018,21,12027,12820,24847
6067,SACRAMENTO,2018,22,11935,12853,24788
6067,SACRAMENTO,2018,23,11757,12621,24378
6067,SACRAMENTO,2018,24,12040,12622,24662
6067,SACRAMENTO,2018,25,11630,12312,23942
6067,SACRAMENTO,2018,26,10034,10734,20768
6067,SACRAMENTO,2018,27,9162,9693,18855
6067,SACRAMENTO,2018,28,8644,9101,17745
6067,SACRAMENTO,2018,29,8743,8944,17687
6067,SACRAMENTO,2018,30,9245,9401,18646
6067,SACRAMENTO,2018,31,9821,9694,19515
6067,SACRAMENTO,2018,32,9992,10033,20025
6067,SACRAMENTO,2018,33,10349,10523,20872
6067,SACRAMENTO,2018,34,10791,10582,21373
6067,SACRAMENTO,2018,35,11090,10849,21939
6067,SACRAMENTO,2018,36,11131,11025,22156
6067,SACRAMENTO,2018,37,10975,10932,21907
6067,SACRAMENTO,2018,38,10830,10990,21820
6067,SACRAMENTO,2018,39,10613,10361,20974
6067,SACRAMENTO,2018,40,10051,10141,20192
6067,SACRAMENTO,2018,41,9948,9996,19944
6067,SACRAMENTO,2018,42,9735,9664,19399
6067,SACRAMENTO,2018,43,9893,9584,19477
6067,SACRAMENTO,2018,44,9546,9450,18996
6067,SACRAMENTO,2018,45,9716,9719,19435
6067,SACRAMENTO,2018,46,9892,9750,19642
6067,SACRAMENTO,2018,47,10303,9879,20182
6067,SACRAMENTO,2018,48,10642,10498,21140
6067,SACRAMENTO,2018,49,9884,9858,19742
6067,SACRAMENTO,2018,50,9479,9548,19027
6067,SACRAMENTO,2018,51,9426,9165,18591
6067,SACRAMENTO,2018,52,9443,9241,18684
6067,SACRAMENTO,2018,53,10040,9670,19710
6067,SACRAMENTO,2018,54,10332,9795,20127
6067,SACRAMENTO,2018,55,10246,9755,20001
6067,SACRAMENTO,2018,56,10036,9621,19657
6067,SACRAMENTO,2018,57,10340,9630,19970
6067,SACRAMENTO,2018,58,10520,9652,20172
6067,SACRAMENTO,2018,59,9971,9007,18978
6067,SACRAMENTO,2018,60,9869,8817,18686
6067,SACRAMENTO,2018,61,9725,8546,18271
6067,SACRAMENTO,2018,62,9534,8184,17718
6067,SACRAMENTO,2018,63,9453,8182,17635
6067,SACRAMENTO,2018,64,8835,7728,16563
6067,SACRAMENTO,2018,65,8566,7274,15840
6067,SACRAMENTO,2018,66,8364,6921,15285
6067,SACRAMENTO,2018,67,7859,6381,14240
6067,SACRAMENTO,2018,68,7825,6611,14436
6067,SACRAMENTO,2018,69,7603,6334,13937
6067,SACRAMENTO,2018,70,7318,6111,13429
6067,SACRAMENTO,2018,71,7170,5860,13030
6067,SACRAMENTO,2018,72,5641,4689,10330
6067,SACRAMENTO,2018,73,5224,4166,9390
6067,SACRAMENTO,2018,74,4963,3802,8765
6067,SACRAMENTO,2018,75,4871,3904,8775
6067,SACRAMENTO,2018,76,4343,3190,7533
6067,SACRAMENTO,2018,77,4030,2998,7028
6067,SACRAMENTO,2018,78,3795,2759,6554
6067,SACRAMENTO,2018,79,3436,2574,6010
6067,SACRAMENTO,2018,80,3432,2453,5885
6067,SACRAMENTO,2018,81,3134,2246,5380
6067,SACRAMENTO,2018,82,2986,1986,4972
6067,SACRAMENTO,2018,83,2657,1845,4502
6067,SACRAMENTO,2018,84,2510,1668,4178
6067,SACRAMENTO,2018,85,2535,1601,4136
6067,SACRAMENTO,2018,86,2308,1512,3820
6067,SACRAMENTO,2018,87,2051,1358,3409
6067,SACRAMENTO,2018,88,1962,1176,3138
6067,SACRAMENTO,2018,89,1579,946,2525
6067,SACRAMENTO,2018,90,1582,854,2436
6067,SACRAMENTO,2018,91,1375,627,2002
6067,SACRAMENTO,2018,92,1160,518,1678
6067,SACRAMENTO,2018,93,901,384,1285
6067,SACRAMENTO,2018,94,666,277,943
6067,SACRAMENTO,2018,95,627,218,845
6067,SACRAMENTO,2018,96,383,168,551
6067,SACRAMENTO,2018,97,281,99,380
6067,SACRAMENTO,2018,98,168,54,222
6067,SACRAMENTO,2018,99,107,28,135
6067,SACRAMENTO,2018,100,145,38,183
6067,SACRAMENTO,2019,0,9088,10238,19326
6067,SACRAMENTO,2019,1,9212,10175,19387
6067,SACRAMENTO,2019,2,9107,10384,19491
6067,SACRAMENTO,2019,3,9604,10152,19756
6067,SACRAMENTO,2019,4,9870,10090,19960
6067,SACRAMENTO,2019,5,9746,10212,19958
6067,SACRAMENTO,2019,6,9618,10061,19679
6067,SACRAMENTO,2019,7,9641,10191,19832
6067,SACRAMENTO,2019,8,10009,10494,20503
6067,SACRAMENTO,2019,9,9549,10192,19741
6067,SACRAMENTO,2019,10,9801,10174,19975
6067,SACRAMENTO,2019,11,10267,10753,21020
6067,SACRAMENTO,2019,12,10429,10734,21163
6067,SACRAMENTO,2019,13,10343,10967,21310
6067,SACRAMENTO,2019,14,10282,10790,21072
6067,SACRAMENTO,2019,15,10198,10584,20782
6067,SACRAMENTO,2019,16,10091,10364,20455
6067,SACRAMENTO,2019,17,10084,10631,20715
6067,SACRAMENTO,2019,18,11430,12195,23625
6067,SACRAMENTO,2019,19,11978,12573,24551
6067,SACRAMENTO,2019,20,12197,12984,25181
6067,SACRAMENTO,2019,21,11915,12613,24528
6067,SACRAMENTO,2019,22,11888,12722,24610
6067,SACRAMENTO,2019,23,11782,12523,24305
6067,SACRAMENTO,2019,24,11824,12668,24492
6067,SACRAMENTO,2019,25,11971,12612,24583
6067,SACRAMENTO,2019,26,10882,11577,22459
6067,SACRAMENTO,2019,27,10160,10893,21053
6067,SACRAMENTO,2019,28,9332,9872,19204
6067,SACRAMENTO,2019,29,8751,9271,18022
6067,SACRAMENTO,2019,30,8859,9034,17893
6067,SACRAMENTO,2019,31,9287,9379,18666
6067,SACRAMENTO,2019,32,9907,9761,19668
6067,SACRAMENTO,2019,33,9982,10026,20008
6067,SACRAMENTO,2019,34,10399,10568,20967
6067,SACRAMENTO,2019,35,10898,10695,21593
6067,SACRAMENTO,2019,36,11049,10842,21891
6067,SACRAMENTO,2019,37,11263,11218,22481
6067,SACRAMENTO,2019,38,11065,10959,22024
6067,SACRAMENTO,2019,39,10925,11120,22045
6067,SACRAMENTO,2019,40,10700,10407,21107
6067,SACRAMENTO,2019,41,10134,10180,20314
6067,SACRAMENTO,2019,42,10017,10089,20106
6067,SACRAMENTO,2019,43,9834,9738,19572
6067,SACRAMENTO,2019,44,9924,9676,19600
6067,SACRAMENTO,2019,45,9643,9570,19213
6067,SACRAMENTO,2019,46,9746,9745,19491
6067,SACRAMENTO,2019,47,9941,9769,19710
6067,SACRAMENTO,2019,48,10336,9861,20197
6067,SACRAMENTO,2019,49,10673,10581,21254
6067,SACRAMENTO,2019,50,9929,9837,19766
6067,SACRAMENTO,2019,51,9496,9531,19027
6067,SACRAMENTO,2019,52,9435,9156,18591
6067,SACRAMENTO,2019,53,9464,9168,18632
6067,SACRAMENTO,2019,54,10066,9715,19781
6067,SACRAMENTO,2019,55,10339,9711,20050
6067,SACRAMENTO,2019,56,10212,9652,19864
6067,SACRAMENTO,2019,57,9970,9537,19507
6067,SACRAMENTO,2019,58,10251,9524,19775
6067,SACRAMENTO,2019,59,10480,9576,20056
6067,SACRAMENTO,2019,60,9909,8873,18782
6067,SACRAMENTO,2019,61,9808,8698,18506
6067,SACRAMENTO,2019,62,9680,8451,18131
6067,SACRAMENTO,2019,63,9470,8085,17555
6067,SACRAMENTO,2019,64,9373,8063,17436
6067,SACRAMENTO,2019,65,8832,7614,16446
6067,SACRAMENTO,2019,66,8542,7162,15704
6067,SACRAMENTO,2019,67,8335,6819,15154
6067,SACRAMENTO,2019,68,7789,6258,14047
6067,SACRAMENTO,2019,69,7770,6503,14273
6067,SACRAMENTO,2019,70,7563,6252,13815
6067,SACRAMENTO,2019,71,7205,5991,13196
6067,SACRAMENTO,2019,72,7080,5709,12789
6067,SACRAMENTO,2019,73,5591,4586,10177
6067,SACRAMENTO,2019,74,5130,4040,9170
6067,SACRAMENTO,2019,75,4937,3735,8672
6067,SACRAMENTO,2019,76,4716,3783,8499
6067,SACRAMENTO,2019,77,4264,3055,7319
6067,SACRAMENTO,2019,78,3894,2880,6774
6067,SACRAMENTO,2019,79,3694,2671,6365
6067,SACRAMENTO,2019,80,3415,2502,5917
6067,SACRAMENTO,2019,81,3240,2289,5529
6067,SACRAMENTO,2019,82,2990,2092,5082
6067,SACRAMENTO,2019,83,2853,1841,4694
6067,SACRAMENTO,2019,84,2552,1773,4325
6067,SACRAMENTO,2019,85,2481,1599,4080
6067,SACRAMENTO,2019,86,2375,1456,3831
6067,SACRAMENTO,2019,87,2089,1388,3477
6067,SACRAMENTO,2019,88,1880,1217,3097
6067,SACRAMENTO,2019,89,1829,1060,2889
6067,SACRAMENTO,2019,90,1414,839,2253
6067,SACRAMENTO,2019,91,1340,690,2030
6067,SACRAMENTO,2019,92,1174,509,1683
6067,SACRAMENTO,2019,93,981,425,1406
6067,SACRAMENTO,2019,94,760,331,1091
6067,SACRAMENTO,2019,95,569,209,778
6067,SACRAMENTO,2019,96,435,144,579
6067,SACRAMENTO,2019,97,300,108,408
6067,SACRAMENTO,2019,98,197,66,263
6067,SACRAMENTO,2019,99,114,42,156
6067,SACRAMENTO,2019,100,160,39,199
6069,SAN BENITO,2017,0,393,368,761
6069,SAN BENITO,2017,1,373,380,753
6069,SAN BENITO,2017,2,366,345,711
6069,SAN BENITO,2017,3,342,379,721
6069,SAN BENITO,2017,4,364,376,740
6069,SAN BENITO,2017,5,328,386,714
6069,SAN BENITO,2017,6,377,376,753
6069,SAN BENITO,2017,7,373,377,750
6069,SAN BENITO,2017,8,364,393,757
6069,SAN BENITO,2017,9,405,430,835
6069,SAN BENITO,2017,10,420,421,841
6069,SAN BENITO,2017,11,440,443,883
6069,SAN BENITO,2017,12,443,397,840
6069,SAN BENITO,2017,13,424,445,869
6069,SAN BENITO,2017,14,417,427,844
6069,SAN BENITO,2017,15,421,442,863
6069,SAN BENITO,2017,16,422,473,895
6069,SAN BENITO,2017,17,450,459,909
6069,SAN BENITO,2017,18,398,499,897
6069,SAN BENITO,2017,19,468,494,962
6069,SAN BENITO,2017,20,436,478,914
6069,SAN BENITO,2017,21,492,508,1000
6069,SAN BENITO,2017,22,456,457,913
6069,SAN BENITO,2017,23,499,472,971
6069,SAN BENITO,2017,24,504,511,1015
6069,SAN BENITO,2017,25,383,472,855
6069,SAN BENITO,2017,26,351,438,789
6069,SAN BENITO,2017,27,361,395,756
6069,SAN BENITO,2017,28,332,376,708
6069,SAN BENITO,2017,29,332,329,661
6069,SAN BENITO,2017,30,318,359,677
6069,SAN BENITO,2017,31,350,345,695
6069,SAN BENITO,2017,32,344,363,707
6069,SAN BENITO,2017,33,359,365,724
6069,SAN BENITO,2017,34,321,350,671
6069,SAN BENITO,2017,35,359,357,716
6069,SAN BENITO,2017,36,346,307,653
6069,SAN BENITO,2017,37,357,378,735
6069,SAN BENITO,2017,38,334,345,679
6069,SAN BENITO,2017,39,364,349,713
6069,SAN BENITO,2017,40,352,329,681
6069,SAN BENITO,2017,41,344,341,685
6069,SAN BENITO,2017,42,358,345,703
6069,SAN BENITO,2017,43,328,323,651
6069,SAN BENITO,2017,44,352,328,680
6069,SAN BENITO,2017,45,341,357,698
6069,SAN BENITO,2017,46,373,377,750
6069,SAN BENITO,2017,47,428,418,846
6069,SAN BENITO,2017,48,415,391,806
6069,SAN BENITO,2017,49,388,365,753
6069,SAN BENITO,2017,50,439,379,818
6069,SAN BENITO,2017,51,401,413,814
6069,SAN BENITO,2017,52,436,399,835
6069,SAN BENITO,2017,53,414,429,843
6069,SAN BENITO,2017,54,429,408,837
6069,SAN BENITO,2017,55,410,422,832
6069,SAN BENITO,2017,56,415,393,808
6069,SAN BENITO,2017,57,414,439,853
6069,SAN BENITO,2017,58,408,378,786
6069,SAN BENITO,2017,59,388,368,756
6069,SAN BENITO,2017,60,364,386,750
6069,SAN BENITO,2017,61,369,345,714
6069,SAN BENITO,2017,62,378,339,717
6069,SAN BENITO,2017,63,351,346,697
6069,SAN BENITO,2017,64,340,357,697
6069,SAN BENITO,2017,65,295,281,576
6069,SAN BENITO,2017,66,294,284,578
6069,SAN BENITO,2017,67,309,261,570
6069,SAN BENITO,2017,68,256,270,526
6069,SAN BENITO,2017,69,229,277,506
6069,SAN BENITO,2017,70,240,200,440
6069,SAN BENITO,2017,71,199,207,406
6069,SAN BENITO,2017,72,187,167,354
6069,SAN BENITO,2017,73,207,151,358
6069,SAN BENITO,2017,74,178,158,336
6069,SAN BENITO,2017,75,157,155,312
6069,SAN BENITO,2017,76,143,127,270
6069,SAN BENITO,2017,77,116,117,233
6069,SAN BENITO,2017,78,118,105,223
6069,SAN BENITO,2017,79,111,82,193
6069,SAN BENITO,2017,80,91,105,196
6069,SAN BENITO,2017,81,73,87,160
6069,SAN BENITO,2017,82,69,62,131
6069,SAN BENITO,2017,83,106,71,177
6069,SAN BENITO,2017,84,90,73,163
6069,SAN BENITO,2017,85,91,37,128
6069,SAN BENITO,2017,86,80,62,142
6069,SAN BENITO,2017,87,88,40,128
6069,SAN BENITO,2017,88,69,36,105
6069,SAN BENITO,2017,89,63,35,98
6069,SAN BENITO,2017,90,80,18,98
6069,SAN BENITO,2017,91,38,24,62
6069,SAN BENITO,2017,92,38,13,51
6069,SAN BENITO,2017,93,26,8,34
6069,SAN BENITO,2017,94,15,1,16
6069,SAN BENITO,2017,95,14,9,23
6069,SAN BENITO,2017,96,14,13,27
6069,SAN BENITO,2017,97,7,5,12
6069,SAN BENITO,2017,98,8,4,12
6069,SAN BENITO,2017,99,9,0,9
6069,SAN BENITO,2017,100,6,0,6
6069,SAN BENITO,2018,0,347,404,751
6069,SAN BENITO,2018,1,393,364,757
6069,SAN BENITO,2018,2,373,379,752
6069,SAN BENITO,2018,3,366,344,710
6069,SAN BENITO,2018,4,345,379,724
6069,SAN BENITO,2018,5,363,374,737
6069,SAN BENITO,2018,6,325,390,715
6069,SAN BENITO,2018,7,377,373,750
6069,SAN BENITO,2018,8,373,383,756
6069,SAN BENITO,2018,9,370,387,757
6069,SAN BENITO,2018,10,400,432,832
6069,SAN BENITO,2018,11,423,419,842
6069,SAN BENITO,2018,12,437,443,880
6069,SAN BENITO,2018,13,450,400,850
6069,SAN BENITO,2018,14,417,447,864
6069,SAN BENITO,2018,15,417,423,840
6069,SAN BENITO,2018,16,423,442,865
6069,SAN BENITO,2018,17,423,473,896
6069,SAN BENITO,2018,18,454,466,920
6069,SAN BENITO,2018,19,396,494,890
6069,SAN BENITO,2018,20,471,502,973
6069,SAN BENITO,2018,21,436,471,907
6069,SAN BENITO,2018,22,491,511,1002
6069,SAN BENITO,2018,23,458,457,915
6069,SAN BENITO,2018,24,501,474,975
6069,SAN BENITO,2018,25,502,513,1015
6069,SAN BENITO,2018,26,386,484,870
6069,SAN BENITO,2018,27,348,425,773
6069,SAN BENITO,2018,28,363,392,755
6069,SAN BENITO,2018,29,332,378,710
6069,SAN BENITO,2018,30,330,330,660
6069,SAN BENITO,2018,31,326,365,691
6069,SAN BENITO,2018,32,356,351,707
6069,SAN BENITO,2018,33,354,370,724
6069,SAN BENITO,2018,34,358,371,729
6069,SAN BENITO,2018,35,329,353,682
6069,SAN BENITO,2018,36,358,357,715
6069,SAN BENITO,2018,37,348,305,653
6069,SAN BENITO,2018,38,356,379,735
6069,SAN BENITO,2018,39,336,341,677
6069,SAN BENITO,2018,40,366,352,718
6069,SAN BENITO,2018,41,348,327,675
6069,SAN BENITO,2018,42,345,338,683
6069,SAN BENITO,2018,43,359,349,708
6069,SAN BENITO,2018,44,324,323,647
6069,SAN BENITO,2018,45,353,324,677
6069,SAN BENITO,2018,46,340,360,700
6069,SAN BENITO,2018,47,375,374,749
6069,SAN BENITO,2018,48,427,417,844
6069,SAN BENITO,2018,49,413,386,799
6069,SAN BENITO,2018,50,390,363,753
6069,SAN BENITO,2018,51,438,377,815
6069,SAN BENITO,2018,52,405,411,816
6069,SAN BENITO,2018,53,430,398,828
6069,SAN BENITO,2018,54,418,432,850
6069,SAN BENITO,2018,55,424,401,825
6069,SAN BENITO,2018,56,407,420,827
6069,SAN BENITO,2018,57,410,392,802
6069,SAN BENITO,2018,58,416,439,855
6069,SAN BENITO,2018,59,404,373,777
6069,SAN BENITO,2018,60,388,367,755
6069,SAN BENITO,2018,61,367,387,754
6069,SAN BENITO,2018,62,371,340,711
6069,SAN BENITO,2018,63,373,341,714
6069,SAN BENITO,2018,64,349,338,687
6069,SAN BENITO,2018,65,342,358,700
6069,SAN BENITO,2018,66,295,282,577
6069,SAN BENITO,2018,67,283,277,560
6069,SAN BENITO,2018,68,304,261,565
6069,SAN BENITO,2018,69,254,265,519
6069,SAN BENITO,2018,70,228,274,502
6069,SAN BENITO,2018,71,244,196,440
6069,SAN BENITO,2018,72,195,206,401
6069,SAN BENITO,2018,73,180,163,343
6069,SAN BENITO,2018,74,199,150,349
6069,SAN BENITO,2018,75,180,154,334
6069,SAN BENITO,2018,76,151,147,298
6069,SAN BENITO,2018,77,142,118,260
6069,SAN BENITO,2018,78,112,112,224
6069,SAN BENITO,2018,79,116,106,222
6069,SAN BENITO,2018,80,111,78,189
6069,SAN BENITO,2018,81,90,99,189
6069,SAN BENITO,2018,82,75,87,162
6069,SAN BENITO,2018,83,69,57,126
6069,SAN BENITO,2018,84,92,66,158
6069,SAN BENITO,2018,85,94,72,166
6069,SAN BENITO,2018,86,91,34,125
6069,SAN BENITO,2018,87,68,50,118
6069,SAN BENITO,2018,88,81,36,117
6069,SAN BENITO,2018,89,60,32,92
6069,SAN BENITO,2018,90,57,31,88
6069,SAN BENITO,2018,91,65,13,78
6069,SAN BENITO,2018,92,30,21,51
6069,SAN BENITO,2018,93,35,9,44
6069,SAN BENITO,2018,94,26,6,32
6069,SAN BENITO,2018,95,12,4,16
6069,SAN BENITO,2018,96,13,6,19
6069,SAN BENITO,2018,97,12,6,18
6069,SAN BENITO,2018,98,6,5,11
6069,SAN BENITO,2018,99,6,4,10
6069,SAN BENITO,2018,100,13,0,13
6069,SAN BENITO,2019,0,349,417,766
6069,SAN BENITO,2019,1,347,400,747
6069,SAN BENITO,2019,2,393,363,756
6069,SAN BENITO,2019,3,373,380,753
6069,SAN BENITO,2019,4,369,344,713
6069,SAN BENITO,2019,5,345,377,722
6069,SAN BENITO,2019,6,361,378,739
6069,SAN BENITO,2019,7,325,386,711
6069,SAN BENITO,2019,8,377,379,756
6069,SAN BENITO,2019,9,379,377,756
6069,SAN BENITO,2019,10,365,389,754
6069,SAN BENITO,2019,11,401,429,830
6069,SAN BENITO,2019,12,422,419,841
6069,SAN BENITO,2019,13,444,447,891
6069,SAN BENITO,2019,14,443,401,844
6069,SAN BENITO,2019,15,417,443,860
6069,SAN BENITO,2019,16,419,424,843
6069,SAN BENITO,2019,17,425,443,868
6069,SAN BENITO,2019,18,429,479,908
6069,SAN BENITO,2019,19,453,464,917
6069,SAN BENITO,2019,20,401,502,903
6069,SAN BENITO,2019,21,471,495,966
6069,SAN BENITO,2019,22,437,475,912
6069,SAN BENITO,2019,23,492,513,1005
6069,SAN BENITO,2019,24,461,459,920
6069,SAN BENITO,2019,25,497,475,972
6069,SAN BENITO,2019,26,504,524,1028
6069,SAN BENITO,2019,27,384,471,855
6069,SAN BENITO,2019,28,351,423,774
6069,SAN BENITO,2019,29,364,394,758
6069,SAN BENITO,2019,30,330,378,708
6069,SAN BENITO,2019,31,338,335,673
6069,SAN BENITO,2019,32,331,376,707
6069,SAN BENITO,2019,33,371,353,724
6069,SAN BENITO,2019,34,352,377,729
6069,SAN BENITO,2019,35,364,376,740
6069,SAN BENITO,2019,36,329,351,680
6069,SAN BENITO,2019,37,359,357,716
6069,SAN BENITO,2019,38,349,307,656
6069,SAN BENITO,2019,39,358,374,732
6069,SAN BENITO,2019,40,338,343,681
6069,SAN BENITO,2019,41,364,351,715
6069,SAN BENITO,2019,42,348,324,672
6069,SAN BENITO,2019,43,346,341,687
6069,SAN BENITO,2019,44,356,350,706
6069,SAN BENITO,2019,45,325,318,643
6069,SAN BENITO,2019,46,352,328,680
6069,SAN BENITO,2019,47,340,360,700
6069,SAN BENITO,2019,48,376,373,749
6069,SAN BENITO,2019,49,421,416,837
6069,SAN BENITO,2019,50,414,384,798
6069,SAN BENITO,2019,51,390,364,754
6069,SAN BENITO,2019,52,442,373,815
6069,SAN BENITO,2019,53,398,408,806
6069,SAN BENITO,2019,54,433,397,830
6069,SAN BENITO,2019,55,414,425,839
6069,SAN BENITO,2019,56,425,397,822
6069,SAN BENITO,2019,57,402,416,818
6069,SAN BENITO,2019,58,412,390,802
6069,SAN BENITO,2019,59,413,436,849
6069,SAN BENITO,2019,60,402,366,768
6069,SAN BENITO,2019,61,391,365,756
6069,SAN BENITO,2019,62,368,384,752
6069,SAN BENITO,2019,63,366,344,710
6069,SAN BENITO,2019,64,372,333,705
6069,SAN BENITO,2019,65,351,337,688
6069,SAN BENITO,2019,66,344,359,703
6069,SAN BENITO,2019,67,289,275,564
6069,SAN BENITO,2019,68,279,280,559
6069,SAN BENITO,2019,69,301,253,554
6069,SAN BENITO,2019,70,252,263,515
6069,SAN BENITO,2019,71,232,267,499
6069,SAN BENITO,2019,72,239,193,432
6069,SAN BENITO,2019,73,189,203,392
6069,SAN BENITO,2019,74,177,161,338
6069,SAN BENITO,2019,75,197,146,343
6069,SAN BENITO,2019,76,177,147,324
6069,SAN BENITO,2019,77,149,141,290
6069,SAN BENITO,2019,78,138,113,251
6069,SAN BENITO,2019,79,111,112,223
6069,SAN BENITO,2019,80,115,102,217
6069,SAN BENITO,2019,81,109,72,181
6069,SAN BENITO,2019,82,92,97,189
6069,SAN BENITO,2019,83,74,85,159
6069,SAN BENITO,2019,84,57,55,112
6069,SAN BENITO,2019,85,95,62,157
6069,SAN BENITO,2019,86,90,67,157
6069,SAN BENITO,2019,87,85,28,113
6069,SAN BENITO,2019,88,63,49,112
6069,SAN BENITO,2019,89,73,33,106
6069,SAN BENITO,2019,90,55,29,84
6069,SAN BENITO,2019,91,50,25,75
6069,SAN BENITO,2019,92,53,11,64
6069,SAN BENITO,2019,93,29,15,44
6069,SAN BENITO,2019,94,33,5,38
6069,SAN BENITO,2019,95,20,8,28
6069,SAN BENITO,2019,96,9,0,9
6069,SAN BENITO,2019,97,10,6,16
6069,SAN BENITO,2019,98,8,4,12
6069,SAN BENITO,2019,99,6,4,10
6069,SAN BENITO,2019,100,13,2,15
6071,SAN BERNARDINO,2017,0,14481,15831,30312
6071,SAN BERNARDINO,2017,1,14767,15522,30289
6071,SAN BERNARDINO,2017,2,15120,15870,30990
6071,SAN BERNARDINO,2017,3,14995,15584,30579
6071,SAN BERNARDINO,2017,4,15017,15540,30557
6071,SAN BERNARDINO,2017,5,14725,15466,30191
6071,SAN BERNARDINO,2017,6,15703,16379,32082
6071,SAN BERNARDINO,2017,7,15558,16027,31585
6071,SAN BERNARDINO,2017,8,16015,16577,32592
6071,SAN BERNARDINO,2017,9,16487,17430,33917
6071,SAN BERNARDINO,2017,10,16791,17652,34443
6071,SAN BERNARDINO,2017,11,16710,17530,34240
6071,SAN BERNARDINO,2017,12,16198,17220,33418
6071,SAN BERNARDINO,2017,13,16100,16829,32929
6071,SAN BERNARDINO,2017,14,16014,16949,32963
6071,SAN BERNARDINO,2017,15,15648,16623,32271
6071,SAN BERNARDINO,2017,16,15908,16937,32845
6071,SAN BERNARDINO,2017,17,16202,17324,33526
6071,SAN BERNARDINO,2017,18,17040,18170,35210
6071,SAN BERNARDINO,2017,19,17669,18882,36551
6071,SAN BERNARDINO,2017,20,17556,19329,36885
6071,SAN BERNARDINO,2017,21,17520,19104,36624
6071,SAN BERNARDINO,2017,22,17152,18570,35722
6071,SAN BERNARDINO,2017,23,17484,18317,35801
6071,SAN BERNARDINO,2017,24,17013,18224,35237
6071,SAN BERNARDINO,2017,25,15793,17241,33034
6071,SAN BERNARDINO,2017,26,14508,16198,30706
6071,SAN BERNARDINO,2017,27,14337,15475,29812
6071,SAN BERNARDINO,2017,28,14235,14731,28966
6071,SAN BERNARDINO,2017,29,14073,14731,28804
6071,SAN BERNARDINO,2017,30,13740,14253,27993
6071,SAN BERNARDINO,2017,31,14062,14519,28581
6071,SAN BERNARDINO,2017,32,14759,14876,29635
6071,SAN BERNARDINO,2017,33,14398,14736,29134
6071,SAN BERNARDINO,2017,34,14680,14907,29587
6071,SAN BERNARDINO,2017,35,14646,14627,29273
6071,SAN BERNARDINO,2017,36,14548,14551,29099
6071,SAN BERNARDINO,2017,37,14711,14643,29354
6071,SAN BERNARDINO,2017,38,13759,13596,27355
6071,SAN BERNARDINO,2017,39,13580,13589,27169
6071,SAN BERNARDINO,2017,40,13680,13192,26872
6071,SAN BERNARDINO,2017,41,13484,12981,26465
6071,SAN BERNARDINO,2017,42,13747,13254,27001
6071,SAN BERNARDINO,2017,43,13409,12759,26168
6071,SAN BERNARDINO,2017,44,13555,12810,26365
6071,SAN BERNARDINO,2017,45,13491,12942,26433
6071,SAN BERNARDINO,2017,46,14403,13427,27830
6071,SAN BERNARDINO,2017,47,14675,14064,28739
6071,SAN BERNARDINO,2017,48,13653,13373,27026
6071,SAN BERNARDINO,2017,49,13372,13196,26568
6071,SAN BERNARDINO,2017,50,13331,12886,26217
6071,SAN BERNARDINO,2017,51,13314,12864,26178
6071,SAN BERNARDINO,2017,52,14026,13558,27584
6071,SAN BERNARDINO,2017,53,14263,13434,27697
6071,SAN BERNARDINO,2017,54,14014,13291,27305
6071,SAN BERNARDINO,2017,55,14054,13063,27117
6071,SAN BERNARDINO,2017,56,14041,13000,27041
6071,SAN BERNARDINO,2017,57,13897,13539,27436
6071,SAN BERNARDINO,2017,58,13356,12559,25915
6071,SAN BERNARDINO,2017,59,13340,12221,25561
6071,SAN BERNARDINO,2017,60,12938,12048,24986
6071,SAN BERNARDINO,2017,61,12528,11284,23812
6071,SAN BERNARDINO,2017,62,11936,11183,23119
6071,SAN BERNARDINO,2017,63,11578,10484,22062
6071,SAN BERNARDINO,2017,64,10829,9650,20479
6071,SAN BERNARDINO,2017,65,10093,9012,19105
6071,SAN BERNARDINO,2017,66,9468,8669,18137
6071,SAN BERNARDINO,2017,67,9273,8316,17589
6071,SAN BERNARDINO,2017,68,8559,7729,16288
6071,SAN BERNARDINO,2017,69,8514,7599,16113
6071,SAN BERNARDINO,2017,70,8104,7430,15534
6071,SAN BERNARDINO,2017,71,6708,5991,12699
6071,SAN BERNARDINO,2017,72,6214,5510,11724
6071,SAN BERNARDINO,2017,73,6133,5283,11416
6071,SAN BERNARDINO,2017,74,5872,4991,10863
6071,SAN BERNARDINO,2017,75,5371,4404,9775
6071,SAN BERNARDINO,2017,76,4858,3909,8767
6071,SAN BERNARDINO,2017,77,4508,3585,8093
6071,SAN BERNARDINO,2017,78,4303,3229,7532
6071,SAN BERNARDINO,2017,79,3969,3089,7058
6071,SAN BERNARDINO,2017,80,3811,2900,6711
6071,SAN BERNARDINO,2017,81,3537,2565,6102
6071,SAN BERNARDINO,2017,82,3385,2236,5621
6071,SAN BERNARDINO,2017,83,2966,2050,5016
6071,SAN BERNARDINO,2017,84,2806,1857,4663
6071,SAN BERNARDINO,2017,85,2668,1770,4438
6071,SAN BERNARDINO,2017,86,2519,1564,4083
6071,SAN BERNARDINO,2017,87,2198,1331,3529
6071,SAN BERNARDINO,2017,88,1894,1073,2967
6071,SAN BERNARDINO,2017,89,1680,973,2653
6071,SAN BERNARDINO,2017,90,1554,843,2397
6071,SAN BERNARDINO,2017,91,1371,605,1976
6071,SAN BERNARDINO,2017,92,1007,440,1447
6071,SAN BERNARDINO,2017,93,698,310,1008
6071,SAN BERNARDINO,2017,94,621,264,885
6071,SAN BERNARDINO,2017,95,517,219,736
6071,SAN BERNARDINO,2017,96,346,138,484
6071,SAN BERNARDINO,2017,97,168,74,242
6071,SAN BERNARDINO,2017,98,148,52,200
6071,SAN BERNARDINO,2017,99,87,28,115
6071,SAN BERNARDINO,2017,100,117,40,157
6071,SAN BERNARDINO,2018,0,14097,15765,29862
6071,SAN BERNARDINO,2018,1,14401,15715,30116
6071,SAN BERNARDINO,2018,2,14816,15562,30378
6071,SAN BERNARDINO,2018,3,15184,15946,31130
6071,SAN BERNARDINO,2018,4,15051,15619,30670
6071,SAN BERNARDINO,2018,5,15086,15583,30669
6071,SAN BERNARDINO,2018,6,15052,15788,30840
6071,SAN BERNARDINO,2018,7,16028,16641,32669
6071,SAN BERNARDINO,2018,8,15839,16290,32129
6071,SAN BERNARDINO,2018,9,16207,16809,33016
6071,SAN BERNARDINO,2018,10,16699,17791,34490
6071,SAN BERNARDINO,2018,11,16858,17721,34579
6071,SAN BERNARDINO,2018,12,16795,17594,34389
6071,SAN BERNARDINO,2018,13,16287,17267,33554
6071,SAN BERNARDINO,2018,14,16175,16873,33048
6071,SAN BERNARDINO,2018,15,16093,17021,33114
6071,SAN BERNARDINO,2018,16,15629,16637,32266
6071,SAN BERNARDINO,2018,17,15916,16985,32901
6071,SAN BERNARDINO,2018,18,17198,18647,35845
6071,SAN BERNARDINO,2018,19,17649,19052,36701
6071,SAN BERNARDINO,2018,20,17503,18939,36442
6071,SAN BERNARDINO,2018,21,17278,18997,36275
6071,SAN BERNARDINO,2018,22,17279,18843,36122
6071,SAN BERNARDINO,2018,23,17087,18229,35316
6071,SAN BERNARDINO,2018,24,17089,17945,35034
6071,SAN BERNARDINO,2018,25,16830,17868,34698
6071,SAN BERNARDINO,2018,26,15367,16809,32176
6071,SAN BERNARDINO,2018,27,14541,16279,30820
6071,SAN BERNARDINO,2018,28,14408,15409,29817
6071,SAN BERNARDINO,2018,29,14245,14757,29002
6071,SAN BERNARDINO,2018,30,14074,14735,28809
6071,SAN BERNARDINO,2018,31,13852,14252,28104
6071,SAN BERNARDINO,2018,32,14158,14693,28851
6071,SAN BERNARDINO,2018,33,14826,14837,29663
6071,SAN BERNARDINO,2018,34,14450,14857,29307
6071,SAN BERNARDINO,2018,35,14736,14900,29636
6071,SAN BERNARDINO,2018,36,14632,14659,29291
6071,SAN BERNARDINO,2018,37,14561,14580,29141
6071,SAN BERNARDINO,2018,38,14759,14668,29427
6071,SAN BERNARDINO,2018,39,13809,13668,27477
6071,SAN BERNARDINO,2018,40,13593,13564,27157
6071,SAN BERNARDINO,2018,41,13667,13134,26801
6071,SAN BERNARDINO,2018,42,13462,12951,26413
6071,SAN BERNARDINO,2018,43,13738,13178,26916
6071,SAN BERNARDINO,2018,44,13395,12762,26157
6071,SAN BERNARDINO,2018,45,13512,12817,26329
6071,SAN BERNARDINO,2018,46,13492,12835,26327
6071,SAN BERNARDINO,2018,47,14406,13452,27858
6071,SAN BERNARDINO,2018,48,14690,14054,28744
6071,SAN BERNARDINO,2018,49,13651,13319,26970
6071,SAN BERNARDINO,2018,50,13320,13104,26424
6071,SAN BERNARDINO,2018,51,13231,12745,25976
6071,SAN BERNARDINO,2018,52,13245,12783,26028
6071,SAN BERNARDINO,2018,53,13943,13450,27393
6071,SAN BERNARDINO,2018,54,14181,13344,27525
6071,SAN BERNARDINO,2018,55,13919,13096,27015
6071,SAN BERNARDINO,2018,56,13943,12932,26875
6071,SAN BERNARDINO,2018,57,13949,12865,26814
6071,SAN BERNARDINO,2018,58,13799,13350,27149
6071,SAN BERNARDINO,2018,59,13237,12438,25675
6071,SAN BERNARDINO,2018,60,13268,12102,25370
6071,SAN BERNARDINO,2018,61,12777,11813,24590
6071,SAN BERNARDINO,2018,62,12428,11109,23537
6071,SAN BERNARDINO,2018,63,11810,10987,22797
6071,SAN BERNARDINO,2018,64,11438,10274,21712
6071,SAN BERNARDINO,2018,65,10732,9473,20205
6071,SAN BERNARDINO,2018,66,9975,8811,18786
6071,SAN BERNARDINO,2018,67,9350,8524,17874
6071,SAN BERNARDINO,2018,68,9137,8111,17248
6071,SAN BERNARDINO,2018,69,8444,7577,16021
6071,SAN BERNARDINO,2018,70,8397,7436,15833
6071,SAN BERNARDINO,2018,71,7926,7243,15169
6071,SAN BERNARDINO,2018,72,6620,5863,12483
6071,SAN BERNARDINO,2018,73,6085,5356,11441
6071,SAN BERNARDINO,2018,74,6037,5140,11177
6071,SAN BERNARDINO,2018,75,5805,4855,10660
6071,SAN BERNARDINO,2018,76,5220,4222,9442
6071,SAN BERNARDINO,2018,77,4705,3760,8465
6071,SAN BERNARDINO,2018,78,4404,3410,7814
6071,SAN BERNARDINO,2018,79,4178,3081,7259
6071,SAN BERNARDINO,2018,80,3923,2984,6907
6071,SAN BERNARDINO,2018,81,3651,2710,6361
6071,SAN BERNARDINO,2018,82,3354,2383,5737
6071,SAN BERNARDINO,2018,83,3217,2095,5312
6071,SAN BERNARDINO,2018,84,2841,1908,4749
6071,SAN BERNARDINO,2018,85,2808,1767,4575
6071,SAN BERNARDINO,2018,86,2385,1595,3980
6071,SAN BERNARDINO,2018,87,2305,1405,3710
6071,SAN BERNARDINO,2018,88,2000,1202,3202
6071,SAN BERNARDINO,2018,89,1750,971,2721
6071,SAN BERNARDINO,2018,90,1528,867,2395
6071,SAN BERNARDINO,2018,91,1346,698,2044
6071,SAN BERNARDINO,2018,92,1139,505,1644
6071,SAN BERNARDINO,2018,93,860,351,1211
6071,SAN BERNARDINO,2018,94,602,253,855
6071,SAN BERNARDINO,2018,95,529,210,739
6071,SAN BERNARDINO,2018,96,389,144,533
6071,SAN BERNARDINO,2018,97,257,101,358
6071,SAN BERNARDINO,2018,98,141,52,193
6071,SAN BERNARDINO,2018,99,110,33,143
6071,SAN BERNARDINO,2018,100,147,44,191
6071,SAN BERNARDINO,2019,0,14328,15714,30042
6071,SAN BERNARDINO,2019,1,14014,15646,29660
6071,SAN BERNARDINO,2019,2,14466,15776,30242
6071,SAN BERNARDINO,2019,3,14863,15640,30503
6071,SAN BERNARDINO,2019,4,15243,15996,31239
6071,SAN BERNARDINO,2019,5,15120,15666,30786
6071,SAN BERNARDINO,2019,6,15424,15925,31349
6071,SAN BERNARDINO,2019,7,15402,16126,31528
6071,SAN BERNARDINO,2019,8,16283,16908,33191
6071,SAN BERNARDINO,2019,9,16088,16547,32635
6071,SAN BERNARDINO,2019,10,16445,17199,33644
6071,SAN BERNARDINO,2019,11,16758,17875,34633
6071,SAN BERNARDINO,2019,12,16941,17797,34738
6071,SAN BERNARDINO,2019,13,16886,17654,34540
6071,SAN BERNARDINO,2019,14,16370,17326,33696
6071,SAN BERNARDINO,2019,15,16247,16959,33206
6071,SAN BERNARDINO,2019,16,16108,17070,33178
6071,SAN BERNARDINO,2019,17,15682,16728,32410
6071,SAN BERNARDINO,2019,18,16943,18324,35267
6071,SAN BERNARDINO,2019,19,17842,19563,37405
6071,SAN BERNARDINO,2019,20,17517,19131,36648
6071,SAN BERNARDINO,2019,21,17247,18613,35860
6071,SAN BERNARDINO,2019,22,17053,18748,35801
6071,SAN BERNARDINO,2019,23,17230,18529,35759
6071,SAN BERNARDINO,2019,24,16717,17872,34589
6071,SAN BERNARDINO,2019,25,16925,17612,34537
6071,SAN BERNARDINO,2019,26,16396,17444,33840
6071,SAN BERNARDINO,2019,27,15403,16900,32303
6071,SAN BERNARDINO,2019,28,14623,16202,30825
6071,SAN BERNARDINO,2019,29,14424,15440,29864
6071,SAN BERNARDINO,2019,30,14238,14763,29001
6071,SAN BERNARDINO,2019,31,14172,14741,28913
6071,SAN BERNARDINO,2019,32,13958,14431,28389
6071,SAN BERNARDINO,2019,33,14251,14689,28940
6071,SAN BERNARDINO,2019,34,14885,14965,29850
6071,SAN BERNARDINO,2019,35,14489,14822,29311
6071,SAN BERNARDINO,2019,36,14728,14931,29659
6071,SAN BERNARDINO,2019,37,14650,14686,29336
6071,SAN BERNARDINO,2019,38,14595,14605,29200
6071,SAN BERNARDINO,2019,39,14825,14744,29569
6071,SAN BERNARDINO,2019,40,13819,13651,27470
6071,SAN BERNARDINO,2019,41,13583,13526,27109
6071,SAN BERNARDINO,2019,42,13637,13096,26733
6071,SAN BERNARDINO,2019,43,13467,12860,26327
6071,SAN BERNARDINO,2019,44,13726,13184,26910
6071,SAN BERNARDINO,2019,45,13344,12766,26110
6071,SAN BERNARDINO,2019,46,13522,12713,26235
6071,SAN BERNARDINO,2019,47,13497,12865,26362
6071,SAN BERNARDINO,2019,48,14441,13440,27881
6071,SAN BERNARDINO,2019,49,14694,14008,28702
6071,SAN BERNARDINO,2019,50,13601,13222,26823
6071,SAN BERNARDINO,2019,51,13238,12946,26184
6071,SAN BERNARDINO,2019,52,13182,12668,25850
6071,SAN BERNARDINO,2019,53,13165,12681,25846
6071,SAN BERNARDINO,2019,54,13870,13358,27228
6071,SAN BERNARDINO,2019,55,14083,13154,27237
6071,SAN BERNARDINO,2019,56,13817,12967,26784
6071,SAN BERNARDINO,2019,57,13844,12783,26627
6071,SAN BERNARDINO,2019,58,13866,12689,26555
6071,SAN BERNARDINO,2019,59,13676,13258,26934
6071,SAN BERNARDINO,2019,60,13156,12311,25467
6071,SAN BERNARDINO,2019,61,13126,11873,24999
6071,SAN BERNARDINO,2019,62,12689,11623,24312
6071,SAN BERNARDINO,2019,63,12307,10946,23253
6071,SAN BERNARDINO,2019,64,11653,10796,22449
6071,SAN BERNARDINO,2019,65,11343,10098,21441
6071,SAN BERNARDINO,2019,66,10608,9295,19903
6071,SAN BERNARDINO,2019,67,9837,8640,18477
6071,SAN BERNARDINO,2019,68,9231,8345,17576
6071,SAN BERNARDINO,2019,69,9010,7940,16950
6071,SAN BERNARDINO,2019,70,8350,7439,15789
6071,SAN BERNARDINO,2019,71,8237,7211,15448
6071,SAN BERNARDINO,2019,72,7806,7079,14885
6071,SAN BERNARDINO,2019,73,6507,5705,12212
6071,SAN BERNARDINO,2019,74,6005,5207,11212
6071,SAN BERNARDINO,2019,75,5967,5004,10971
6071,SAN BERNARDINO,2019,76,5635,4649,10284
6071,SAN BERNARDINO,2019,77,5101,4095,9196
6071,SAN BERNARDINO,2019,78,4607,3610,8217
6071,SAN BERNARDINO,2019,79,4271,3288,7559
6071,SAN BERNARDINO,2019,80,4150,2986,7136
6071,SAN BERNARDINO,2019,81,3735,2805,6540
6071,SAN BERNARDINO,2019,82,3476,2522,5998
6071,SAN BERNARDINO,2019,83,3206,2210,5416
6071,SAN BERNARDINO,2019,84,3098,1944,5042
6071,SAN BERNARDINO,2019,85,2836,1818,4654
6071,SAN BERNARDINO,2019,86,2523,1570,4093
6071,SAN BERNARDINO,2019,87,2207,1416,3623
6071,SAN BERNARDINO,2019,88,2111,1290,3401
6071,SAN BERNARDINO,2019,89,1851,1088,2939
6071,SAN BERNARDINO,2019,90,1583,862,2445
6071,SAN BERNARDINO,2019,91,1373,693,2066
6071,SAN BERNARDINO,2019,92,1133,580,1713
6071,SAN BERNARDINO,2019,93,930,420,1350
6071,SAN BERNARDINO,2019,94,747,301,1048
6071,SAN BERNARDINO,2019,95,506,218,724
6071,SAN BERNARDINO,2019,96,413,150,563
6071,SAN BERNARDINO,2019,97,284,106,390
6071,SAN BERNARDINO,2019,98,192,71,263
6071,SAN BERNARDINO,2019,99,100,35,135
6071,SAN BERNARDINO,2019,100,168,52,220
6073,SAN DIEGO,2017,0,20359,22586,42945
6073,SAN DIEGO,2017,1,21070,21900,42970
6073,SAN DIEGO,2017,2,21870,22993,44863
6073,SAN DIEGO,2017,3,22114,23363,45477
6073,SAN DIEGO,2017,4,22285,23295,45580
6073,SAN DIEGO,2017,5,22455,23731,46186
6073,SAN DIEGO,2017,6,23344,24526,47870
6073,SAN DIEGO,2017,7,22063,22902,44965
6073,SAN DIEGO,2017,8,22403,23367,45770
6073,SAN DIEGO,2017,9,22426,23236,45662
6073,SAN DIEGO,2017,10,22225,22991,45216
6073,SAN DIEGO,2017,11,21425,22492,43917
6073,SAN DIEGO,2017,12,20650,21708,42358
6073,SAN DIEGO,2017,13,20122,21334,41456
6073,SAN DIEGO,2017,14,19936,20951,40887
6073,SAN DIEGO,2017,15,19396,20334,39730
6073,SAN DIEGO,2017,16,19725,20758,40483
6073,SAN DIEGO,2017,17,19927,21490,41417
6073,SAN DIEGO,2017,18,24388,28073,52461
6073,SAN DIEGO,2017,19,25814,29336,55150
6073,SAN DIEGO,2017,20,24253,30292,54545
6073,SAN DIEGO,2017,21,24196,30516,54712
6073,SAN DIEGO,2017,22,22929,28681,51610
6073,SAN DIEGO,2017,23,22455,28250,50705
6073,SAN DIEGO,2017,24,22468,28164,50632
6073,SAN DIEGO,2017,25,20678,23117,43795
6073,SAN DIEGO,2017,26,20030,22902,42932
6073,SAN DIEGO,2017,27,20202,22369,42571
6073,SAN DIEGO,2017,28,21083,23223,44306
6073,SAN DIEGO,2017,29,21142,23334,44476
6073,SAN DIEGO,2017,30,21179,22318,43497
6073,SAN DIEGO,2017,31,20931,21592,42523
6073,SAN DIEGO,2017,32,22280,24128,46408
6073,SAN DIEGO,2017,33,23222,24773,47995
6073,SAN DIEGO,2017,34,23673,25051,48724
6073,SAN DIEGO,2017,35,23078,24245,47323
6073,SAN DIEGO,2017,36,22924,23806,46730
6073,SAN DIEGO,2017,37,22894,24414,47308
6073,SAN DIEGO,2017,38,21257,22368,43625
6073,SAN DIEGO,2017,39,20779,21811,42590
6073,SAN DIEGO,2017,40,20637,20898,41535
6073,SAN DIEGO,2017,41,20141,20423,40564
6073,SAN DIEGO,2017,42,20597,21241,41838
6073,SAN DIEGO,2017,43,20326,20709,41035
6073,SAN DIEGO,2017,44,20296,20175,40471
6073,SAN DIEGO,2017,45,20695,20896,41591
6073,SAN DIEGO,2017,46,21246,21446,42692
6073,SAN DIEGO,2017,47,22232,22191,44423
6073,SAN DIEGO,2017,48,21074,21097,42171
6073,SAN DIEGO,2017,49,20392,20428,40820
6073,SAN DIEGO,2017,50,19950,19751,39701
6073,SAN DIEGO,2017,51,19979,19824,39803
6073,SAN DIEGO,2017,52,21063,21150,42213
6073,SAN DIEGO,2017,53,21515,21471,42986
6073,SAN DIEGO,2017,54,21500,21125,42625
6073,SAN DIEGO,2017,55,21342,21116,42458
6073,SAN DIEGO,2017,56,21572,21027,42599
6073,SAN DIEGO,2017,57,21703,21335,43038
6073,SAN DIEGO,2017,58,21043,20215,41258
6073,SAN DIEGO,2017,59,20573,19809,40382
6073,SAN DIEGO,2017,60,20596,19189,39785
6073,SAN DIEGO,2017,61,20153,18625,38778
6073,SAN DIEGO,2017,62,19918,18326,38244
6073,SAN DIEGO,2017,63,19121,17395,36516
6073,SAN DIEGO,2017,64,18236,16411,34647
6073,SAN DIEGO,2017,65,17280,15752,33032
6073,SAN DIEGO,2017,66,16609,15042,31651
6073,SAN DIEGO,2017,67,16792,15032,31824
6073,SAN DIEGO,2017,68,16086,14067,30153
6073,SAN DIEGO,2017,69,15901,13753,29654
6073,SAN DIEGO,2017,70,15453,13403,28856
6073,SAN DIEGO,2017,71,12663,11262,23925
6073,SAN DIEGO,2017,72,11970,10072,22042
6073,SAN DIEGO,2017,73,11186,9559,20745
6073,SAN DIEGO,2017,74,10948,9064,20012
6073,SAN DIEGO,2017,75,10109,8510,18619
6073,SAN DIEGO,2017,76,9136,7521,16657
6073,SAN DIEGO,2017,77,8799,7092,15891
6073,SAN DIEGO,2017,78,8357,6567,14924
6073,SAN DIEGO,2017,79,7829,5912,13741
6073,SAN DIEGO,2017,80,7487,5685,13172
6073,SAN DIEGO,2017,81,6957,5187,12144
6073,SAN DIEGO,2017,82,6371,4560,10931
6073,SAN DIEGO,2017,83,5954,4095,10049
6073,SAN DIEGO,2017,84,5624,3875,9499
6073,SAN DIEGO,2017,85,5872,3810,9682
6073,SAN DIEGO,2017,86,5432,3702,9134
6073,SAN DIEGO,2017,87,5006,3313,8319
6073,SAN DIEGO,2017,88,4320,2755,7075
6073,SAN DIEGO,2017,89,4004,2290,6294
6073,SAN DIEGO,2017,90,3738,2093,5831
6073,SAN DIEGO,2017,91,3161,1641,4802
6073,SAN DIEGO,2017,92,2430,1171,3601
6073,SAN DIEGO,2017,93,1916,938,2854
6073,SAN DIEGO,2017,94,1684,734,2418
6073,SAN DIEGO,2017,95,1412,625,2037
6073,SAN DIEGO,2017,96,955,370,1325
6073,SAN DIEGO,2017,97,578,244,822
6073,SAN DIEGO,2017,98,370,153,523
6073,SAN DIEGO,2017,99,263,87,350
6073,SAN DIEGO,2017,100,325,106,431
6073,SAN DIEGO,2018,0,19865,22154,42019
6073,SAN DIEGO,2018,1,20278,22481,42759
6073,SAN DIEGO,2018,2,21464,22337,43801
6073,SAN DIEGO,2018,3,22256,23344,45600
6073,SAN DIEGO,2018,4,22413,23682,46095
6073,SAN DIEGO,2018,5,22588,23642,46230
6073,SAN DIEGO,2018,6,22620,23883,46503
6073,SAN DIEGO,2018,7,23513,24665,48178
6073,SAN DIEGO,2018,8,22185,23042,45227
6073,SAN DIEGO,2018,9,22582,23498,46080
6073,SAN DIEGO,2018,10,22532,23430,45962
6073,SAN DIEGO,2018,11,22306,23087,45393
6073,SAN DIEGO,2018,12,21541,22629,44170
6073,SAN DIEGO,2018,13,20720,21758,42478
6073,SAN DIEGO,2018,14,20219,21408,41627
6073,SAN DIEGO,2018,15,20002,21065,41067
6073,SAN DIEGO,2018,16,19443,20475,39918
6073,SAN DIEGO,2018,17,20004,21237,41241
6073,SAN DIEGO,2018,18,24636,28493,53129
6073,SAN DIEGO,2018,19,25761,29785,55546
6073,SAN DIEGO,2018,20,23956,29562,53518
6073,SAN DIEGO,2018,21,23757,29847,53604
6073,SAN DIEGO,2018,22,23482,30073,53555
6073,SAN DIEGO,2018,23,22569,27877,50446
6073,SAN DIEGO,2018,24,22331,27941,50272
6073,SAN DIEGO,2018,25,21407,23718,45125
6073,SAN DIEGO,2018,26,19146,21580,40726
6073,SAN DIEGO,2018,27,20049,22795,42844
6073,SAN DIEGO,2018,28,20182,22452,42634
6073,SAN DIEGO,2018,29,20931,22934,43865
6073,SAN DIEGO,2018,30,21033,22719,43752
6073,SAN DIEGO,2018,31,21049,22133,43182
6073,SAN DIEGO,2018,32,20989,21513,42502
6073,SAN DIEGO,2018,33,22142,23977,46119
6073,SAN DIEGO,2018,34,23206,24786,47992
6073,SAN DIEGO,2018,35,23537,24857,48394
6073,SAN DIEGO,2018,36,22840,23943,46783
6073,SAN DIEGO,2018,37,22899,23745,46644
6073,SAN DIEGO,2018,38,22879,24351,47230
6073,SAN DIEGO,2018,39,21273,22448,43721
6073,SAN DIEGO,2018,40,20736,21710,42446
6073,SAN DIEGO,2018,41,20599,20827,41426
6073,SAN DIEGO,2018,42,20131,20382,40513
6073,SAN DIEGO,2018,43,20579,21160,41739
6073,SAN DIEGO,2018,44,20285,20621,40906
6073,SAN DIEGO,2018,45,20297,20200,40497
6073,SAN DIEGO,2018,46,20623,20812,41435
6073,SAN DIEGO,2018,47,21205,21411,42616
6073,SAN DIEGO,2018,48,22195,22092,44287
6073,SAN DIEGO,2018,49,21043,21056,42099
6073,SAN DIEGO,2018,50,20365,20284,40649
6073,SAN DIEGO,2018,51,19864,19602,39466
6073,SAN DIEGO,2018,52,19878,19696,39574
6073,SAN DIEGO,2018,53,20986,21051,42037
6073,SAN DIEGO,2018,54,21451,21295,42746
6073,SAN DIEGO,2018,55,21424,20990,42414
6073,SAN DIEGO,2018,56,21216,20899,42115
6073,SAN DIEGO,2018,57,21441,20837,42278
6073,SAN DIEGO,2018,58,21594,21133,42727
6073,SAN DIEGO,2018,59,20918,20060,40978
6073,SAN DIEGO,2018,60,20513,19664,40177
6073,SAN DIEGO,2018,61,20555,18988,39543
6073,SAN DIEGO,2018,62,20049,18469,38518
6073,SAN DIEGO,2018,63,19848,18154,38002
6073,SAN DIEGO,2018,64,19033,17184,36217
6073,SAN DIEGO,2018,65,18189,16285,34474
6073,SAN DIEGO,2018,66,17162,15551,32713
6073,SAN DIEGO,2018,67,16469,14812,31281
6073,SAN DIEGO,2018,68,16664,14816,31480
6073,SAN DIEGO,2018,69,15978,13875,29853
6073,SAN DIEGO,2018,70,15825,13515,29340
6073,SAN DIEGO,2018,71,15305,13213,28518
6073,SAN DIEGO,2018,72,12559,11151,23710
6073,SAN DIEGO,2018,73,11899,9882,21781
6073,SAN DIEGO,2018,74,11075,9406,20481
6073,SAN DIEGO,2018,75,10977,8988,19965
6073,SAN DIEGO,2018,76,9894,8178,18072
6073,SAN DIEGO,2018,77,8951,7290,16241
6073,SAN DIEGO,2018,78,8556,6912,15468
6073,SAN DIEGO,2018,79,8185,6324,14509
6073,SAN DIEGO,2018,80,7731,5822,13553
6073,SAN DIEGO,2018,81,7227,5339,12566
6073,SAN DIEGO,2018,82,6641,4860,11501
6073,SAN DIEGO,2018,83,6083,4297,10380
6073,SAN DIEGO,2018,84,5798,3865,9663
6073,SAN DIEGO,2018,85,5734,3717,9451
6073,SAN DIEGO,2018,86,5480,3480,8960
6073,SAN DIEGO,2018,87,4954,3337,8291
6073,SAN DIEGO,2018,88,4613,3008,7621
6073,SAN DIEGO,2018,89,3961,2456,6417
6073,SAN DIEGO,2018,90,3682,2059,5741
6073,SAN DIEGO,2018,91,3170,1683,4853
6073,SAN DIEGO,2018,92,2693,1318,4011
6073,SAN DIEGO,2018,93,2043,938,2981
6073,SAN DIEGO,2018,94,1627,759,2386
6073,SAN DIEGO,2018,95,1433,582,2015
6073,SAN DIEGO,2018,96,1080,436,1516
6073,SAN DIEGO,2018,97,710,250,960
6073,SAN DIEGO,2018,98,436,176,612
6073,SAN DIEGO,2018,99,287,100,387
6073,SAN DIEGO,2018,100,400,122,522
6073,SAN DIEGO,2019,0,19922,21732,41654
6073,SAN DIEGO,2019,1,19787,22052,41839
6073,SAN DIEGO,2019,2,20689,22909,43598
6073,SAN DIEGO,2019,3,21882,22681,44563
6073,SAN DIEGO,2019,4,22611,23700,46311
6073,SAN DIEGO,2019,5,22711,24056,46767
6073,SAN DIEGO,2019,6,22750,23808,46558
6073,SAN DIEGO,2019,7,22801,24055,46856
6073,SAN DIEGO,2019,8,23634,24823,48457
6073,SAN DIEGO,2019,9,22336,23178,45514
6073,SAN DIEGO,2019,10,22696,23708,46404
6073,SAN DIEGO,2019,11,22613,23559,46172
6073,SAN DIEGO,2019,12,22423,23220,45643
6073,SAN DIEGO,2019,13,21615,22684,44299
6073,SAN DIEGO,2019,14,20807,21866,42673
6073,SAN DIEGO,2019,15,20296,21498,41794
6073,SAN DIEGO,2019,16,20080,21212,41292
6073,SAN DIEGO,2019,17,19763,20979,40742
6073,SAN DIEGO,2019,18,24722,28251,52973
6073,SAN DIEGO,2019,19,26028,30230,56258
6073,SAN DIEGO,2019,20,23932,30049,53981
6073,SAN DIEGO,2019,21,23465,29111,52576
6073,SAN DIEGO,2019,22,23044,29405,52449
6073,SAN DIEGO,2019,23,23117,29271,52388
6073,SAN DIEGO,2019,24,22445,27574,50019
6073,SAN DIEGO,2019,25,21275,23501,44776
6073,SAN DIEGO,2019,26,19876,22182,42058
6073,SAN DIEGO,2019,27,19169,21468,40637
6073,SAN DIEGO,2019,28,20032,22882,42914
6073,SAN DIEGO,2019,29,20030,22170,42200
6073,SAN DIEGO,2019,30,20824,22321,43145
6073,SAN DIEGO,2019,31,20911,22539,43450
6073,SAN DIEGO,2019,32,21115,22060,43175
6073,SAN DIEGO,2019,33,20855,21375,42230
6073,SAN DIEGO,2019,34,22132,24000,46132
6073,SAN DIEGO,2019,35,23066,24594,47660
6073,SAN DIEGO,2019,36,23307,24568,47875
6073,SAN DIEGO,2019,37,22821,23890,46711
6073,SAN DIEGO,2019,38,22873,23690,46563
6073,SAN DIEGO,2019,39,22900,24434,47334
6073,SAN DIEGO,2019,40,21232,22356,43588
6073,SAN DIEGO,2019,41,20698,21644,42342
6073,SAN DIEGO,2019,42,20590,20782,41372
6073,SAN DIEGO,2019,43,20123,20307,40430
6073,SAN DIEGO,2019,44,20525,21076,41601
6073,SAN DIEGO,2019,45,20291,20645,40936
6073,SAN DIEGO,2019,46,20243,20100,40343
6073,SAN DIEGO,2019,47,20600,20792,41392
6073,SAN DIEGO,2019,48,21164,21329,42493
6073,SAN DIEGO,2019,49,22161,22041,44202
6073,SAN DIEGO,2019,50,21027,20913,41940
6073,SAN DIEGO,2019,51,20259,20132,40391
6073,SAN DIEGO,2019,52,19780,19484,39264
6073,SAN DIEGO,2019,53,19785,19610,39395
6073,SAN DIEGO,2019,54,20921,20886,41807
6073,SAN DIEGO,2019,55,21372,21168,42540
6073,SAN DIEGO,2019,56,21319,20757,42076
6073,SAN DIEGO,2019,57,21093,20703,41796
6073,SAN DIEGO,2019,58,21335,20653,41988
6073,SAN DIEGO,2019,59,21458,20977,42435
6073,SAN DIEGO,2019,60,20847,19915,40762
6073,SAN DIEGO,2019,61,20484,19462,39946
6073,SAN DIEGO,2019,62,20463,18827,39290
6073,SAN DIEGO,2019,63,20009,18297,38306
6073,SAN DIEGO,2019,64,19791,17947,37738
6073,SAN DIEGO,2019,65,18971,17055,36026
6073,SAN DIEGO,2019,66,18061,16104,34165
6073,SAN DIEGO,2019,67,17012,15373,32385
6073,SAN DIEGO,2019,68,16338,14625,30963
6073,SAN DIEGO,2019,69,16537,14617,31154
6073,SAN DIEGO,2019,70,15907,13674,29581
6073,SAN DIEGO,2019,71,15689,13350,29039
6073,SAN DIEGO,2019,72,15220,13027,28247
6073,SAN DIEGO,2019,73,12483,10950,23433
6073,SAN DIEGO,2019,74,11766,9760,21526
6073,SAN DIEGO,2019,75,11076,9356,20432
6073,SAN DIEGO,2019,76,10729,8666,19395
6073,SAN DIEGO,2019,77,9661,7932,17593
6073,SAN DIEGO,2019,78,8705,7043,15748
6073,SAN DIEGO,2019,79,8379,6649,15028
6073,SAN DIEGO,2019,80,8094,6222,14316
6073,SAN DIEGO,2019,81,7451,5480,12931
6073,SAN DIEGO,2019,82,6933,4985,11918
6073,SAN DIEGO,2019,83,6304,4565,10869
6073,SAN DIEGO,2019,84,5874,4066,9940
6073,SAN DIEGO,2019,85,5896,3689,9585
6073,SAN DIEGO,2019,86,5350,3407,8757
6073,SAN DIEGO,2019,87,5010,3191,8201
6073,SAN DIEGO,2019,88,4610,3032,7642
6073,SAN DIEGO,2019,89,4217,2731,6948
6073,SAN DIEGO,2019,90,3661,2224,5885
6073,SAN DIEGO,2019,91,3132,1645,4777
6073,SAN DIEGO,2019,92,2706,1327,4033
6073,SAN DIEGO,2019,93,2248,1083,3331
6073,SAN DIEGO,2019,94,1751,771,2522
6073,SAN DIEGO,2019,95,1387,623,2010
6073,SAN DIEGO,2019,96,1086,407,1493
6073,SAN DIEGO,2019,97,815,296,1111
6073,SAN DIEGO,2019,98,564,189,753
6073,SAN DIEGO,2019,99,326,111,437
6073,SAN DIEGO,2019,100,475,134,609
6075,SAN FRANCISCO,2017,0,4260,4706,8966
6075,SAN FRANCISCO,2017,1,4361,4432,8793
6075,SAN FRANCISCO,2017,2,4268,4551,8819
6075,SAN FRANCISCO,2017,3,4186,4421,8607
6075,SAN FRANCISCO,2017,4,4193,4465,8658
6075,SAN FRANCISCO,2017,5,4078,4295,8373
6075,SAN FRANCISCO,2017,6,4097,4356,8453
6075,SAN FRANCISCO,2017,7,3586,3827,7413
6075,SAN FRANCISCO,2017,8,3415,3568,6983
6075,SAN FRANCISCO,2017,9,3301,3550,6851
6075,SAN FRANCISCO,2017,10,3080,3287,6367
6075,SAN FRANCISCO,2017,11,2957,2916,5873
6075,SAN FRANCISCO,2017,12,3010,3004,6014
6075,SAN FRANCISCO,2017,13,2785,2984,5769
6075,SAN FRANCISCO,2017,14,2716,2832,5548
6075,SAN FRANCISCO,2017,15,2662,2593,5255
6075,SAN FRANCISCO,2017,16,2683,2702,5385
6075,SAN FRANCISCO,2017,17,2681,2821,5502
6075,SAN FRANCISCO,2017,18,4653,4284,8937
6075,SAN FRANCISCO,2017,19,4731,4542,9273
6075,SAN FRANCISCO,2017,20,4427,4482,8909
6075,SAN FRANCISCO,2017,21,4715,4869,9584
6075,SAN FRANCISCO,2017,22,4869,4912,9781
6075,SAN FRANCISCO,2017,23,5056,4828,9884
6075,SAN FRANCISCO,2017,24,5176,4927,10103
6075,SAN FRANCISCO,2017,25,5663,5241,10904
6075,SAN FRANCISCO,2017,26,5201,4872,10073
6075,SAN FRANCISCO,2017,27,5869,5663,11532
6075,SAN FRANCISCO,2017,28,6671,6276,12947
6075,SAN FRANCISCO,2017,29,7746,7408,15154
6075,SAN FRANCISCO,2017,30,8984,8936,17920
6075,SAN FRANCISCO,2017,31,9817,9393,19210
6075,SAN FRANCISCO,2017,32,10513,10392,20905
6075,SAN FRANCISCO,2017,33,10469,10655,21124
6075,SAN FRANCISCO,2017,34,10325,10733,21058
6075,SAN FRANCISCO,2017,35,10059,10209,20268
6075,SAN FRANCISCO,2017,36,8900,9307,18207
6075,SAN FRANCISCO,2017,37,8337,8799,17136
6075,SAN FRANCISCO,2017,38,7688,8076,15764
6075,SAN FRANCISCO,2017,39,7415,7814,15229
6075,SAN FRANCISCO,2017,40,6868,7720,14588
6075,SAN FRANCISCO,2017,41,6571,7211,13782
6075,SAN FRANCISCO,2017,42,6402,7525,13927
6075,SAN FRANCISCO,2017,43,6104,7290,13394
6075,SAN FRANCISCO,2017,44,6222,7017,13239
6075,SAN FRANCISCO,2017,45,5875,7082,12957
6075,SAN FRANCISCO,2017,46,6190,7534,13724
6075,SAN FRANCISCO,2017,47,6282,7786,14068
6075,SAN FRANCISCO,2017,48,5829,6983,12812
6075,SAN FRANCISCO,2017,49,5330,6588,11918
6075,SAN FRANCISCO,2017,50,5114,6284,11398
6075,SAN FRANCISCO,2017,51,4978,6409,11387
6075,SAN FRANCISCO,2017,52,5229,6588,11817
6075,SAN FRANCISCO,2017,53,5137,6302,11439
6075,SAN FRANCISCO,2017,54,5212,6131,11343
6075,SAN FRANCISCO,2017,55,4965,5841,10806
6075,SAN FRANCISCO,2017,56,4742,5703,10445
6075,SAN FRANCISCO,2017,57,4808,5805,10613
6075,SAN FRANCISCO,2017,58,4813,5540,10353
6075,SAN FRANCISCO,2017,59,4917,5435,10352
6075,SAN FRANCISCO,2017,60,4862,5409,10271
6075,SAN FRANCISCO,2017,61,4914,5072,9986
6075,SAN FRANCISCO,2017,62,5129,5239,10368
6075,SAN FRANCISCO,2017,63,4834,5103,9937
6075,SAN FRANCISCO,2017,64,4812,4847,9659
6075,SAN FRANCISCO,2017,65,4684,4668,9352
6075,SAN FRANCISCO,2017,66,4624,4607,9231
6075,SAN FRANCISCO,2017,67,5021,4727,9748
6075,SAN FRANCISCO,2017,68,4598,4470,9068
6075,SAN FRANCISCO,2017,69,4480,4211,8691
6075,SAN FRANCISCO,2017,70,4216,3846,8062
6075,SAN FRANCISCO,2017,71,3514,3263,6777
6075,SAN FRANCISCO,2017,72,3307,3054,6361
6075,SAN FRANCISCO,2017,73,3115,2684,5799
6075,SAN FRANCISCO,2017,74,2969,2582,5551
6075,SAN FRANCISCO,2017,75,2826,2404,5230
6075,SAN FRANCISCO,2017,76,2646,2166,4812
6075,SAN FRANCISCO,2017,77,2580,2167,4747
6075,SAN FRANCISCO,2017,78,2494,1973,4467
6075,SAN FRANCISCO,2017,79,2411,1901,4312
6075,SAN FRANCISCO,2017,80,2352,1813,4165
6075,SAN FRANCISCO,2017,81,2201,1706,3907
6075,SAN FRANCISCO,2017,82,2050,1569,3619
6075,SAN FRANCISCO,2017,83,2030,1467,3497
6075,SAN FRANCISCO,2017,84,1909,1373,3282
6075,SAN FRANCISCO,2017,85,1881,1270,3151
6075,SAN FRANCISCO,2017,86,1786,1226,3012
6075,SAN FRANCISCO,2017,87,1667,1074,2741
6075,SAN FRANCISCO,2017,88,1600,893,2493
6075,SAN FRANCISCO,2017,89,1519,812,2331
6075,SAN FRANCISCO,2017,90,1316,778,2094
6075,SAN FRANCISCO,2017,91,1096,550,1646
6075,SAN FRANCISCO,2017,92,915,450,1365
6075,SAN FRANCISCO,2017,93,693,331,1024
6075,SAN FRANCISCO,2017,94,556,270,826
6075,SAN FRANCISCO,2017,95,451,213,664
6075,SAN FRANCISCO,2017,96,323,129,452
6075,SAN FRANCISCO,2017,97,246,81,327
6075,SAN FRANCISCO,2017,98,162,50,212
6075,SAN FRANCISCO,2017,99,115,47,162
6075,SAN FRANCISCO,2017,100,155,70,225
6075,SAN FRANCISCO,2018,0,4351,4684,9035
6075,SAN FRANCISCO,2018,1,4218,4644,8862
6075,SAN FRANCISCO,2018,2,4318,4379,8697
6075,SAN FRANCISCO,2018,3,4234,4501,8735
6075,SAN FRANCISCO,2018,4,4131,4371,8502
6075,SAN FRANCISCO,2018,5,4143,4409,8552
6075,SAN FRANCISCO,2018,6,4062,4277,8339
6075,SAN FRANCISCO,2018,7,4082,4327,8409
6075,SAN FRANCISCO,2018,8,3562,3805,7367
6075,SAN FRANCISCO,2018,9,3403,3556,6959
6075,SAN FRANCISCO,2018,10,3284,3534,6818
6075,SAN FRANCISCO,2018,11,3070,3283,6353
6075,SAN FRANCISCO,2018,12,2957,2906,5863
6075,SAN FRANCISCO,2018,13,2997,2997,5994
6075,SAN FRANCISCO,2018,14,2786,2976,5762
6075,SAN FRANCISCO,2018,15,2734,2818,5552
6075,SAN FRANCISCO,2018,16,2664,2572,5236
6075,SAN FRANCISCO,2018,17,2790,2778,5568
6075,SAN FRANCISCO,2018,18,4665,4486,9151
6075,SAN FRANCISCO,2018,19,4764,4451,9215
6075,SAN FRANCISCO,2018,20,4281,4522,8803
6075,SAN FRANCISCO,2018,21,4778,4727,9505
6075,SAN FRANCISCO,2018,22,4988,5026,10014
6075,SAN FRANCISCO,2018,23,4970,4864,9834
6075,SAN FRANCISCO,2018,24,5259,5088,10347
6075,SAN FRANCISCO,2018,25,5372,4992,10364
6075,SAN FRANCISCO,2018,26,5216,5035,10251
6075,SAN FRANCISCO,2018,27,5559,5290,10849
6075,SAN FRANCISCO,2018,28,6289,6166,12455
6075,SAN FRANCISCO,2018,29,7118,6746,13864
6075,SAN FRANCISCO,2018,30,7963,7663,15626
6075,SAN FRANCISCO,2018,31,8843,8794,17637
6075,SAN FRANCISCO,2018,32,9755,9408,19163
6075,SAN FRANCISCO,2018,33,10556,10423,20979
6075,SAN FRANCISCO,2018,34,10434,10620,21054
6075,SAN FRANCISCO,2018,35,10311,10714,21025
6075,SAN FRANCISCO,2018,36,9821,9965,19786
6075,SAN FRANCISCO,2018,37,8847,9223,18070
6075,SAN FRANCISCO,2018,38,8269,8742,17011
6075,SAN FRANCISCO,2018,39,7630,8032,15662
6075,SAN FRANCISCO,2018,40,7385,7858,15243
6075,SAN FRANCISCO,2018,41,6813,7616,14429
6075,SAN FRANCISCO,2018,42,6529,7114,13643
6075,SAN FRANCISCO,2018,43,6355,7477,13832
6075,SAN FRANCISCO,2018,44,6066,7224,13290
6075,SAN FRANCISCO,2018,45,6184,7086,13270
6075,SAN FRANCISCO,2018,46,5867,7020,12887
6075,SAN FRANCISCO,2018,47,6198,7477,13675
6075,SAN FRANCISCO,2018,48,6230,7762,13992
6075,SAN FRANCISCO,2018,49,5836,6990,12826
6075,SAN FRANCISCO,2018,50,5326,6569,11895
6075,SAN FRANCISCO,2018,51,5081,6204,11285
6075,SAN FRANCISCO,2018,52,4950,6385,11335
6075,SAN FRANCISCO,2018,53,5196,6524,11720
6075,SAN FRANCISCO,2018,54,5099,6253,11352
6075,SAN FRANCISCO,2018,55,5187,6063,11250
6075,SAN FRANCISCO,2018,56,4953,5813,10766
6075,SAN FRANCISCO,2018,57,4730,5677,10407
6075,SAN FRANCISCO,2018,58,4777,5731,10508
6075,SAN FRANCISCO,2018,59,4811,5536,10347
6075,SAN FRANCISCO,2018,60,4891,5330,10221
6075,SAN FRANCISCO,2018,61,4827,5316,10143
6075,SAN FRANCISCO,2018,62,4895,5012,9907
6075,SAN FRANCISCO,2018,63,5099,5162,10261
6075,SAN FRANCISCO,2018,64,4786,5004,9790
6075,SAN FRANCISCO,2018,65,4795,4802,9597
6075,SAN FRANCISCO,2018,66,4681,4592,9273
6075,SAN FRANCISCO,2018,67,4596,4534,9130
6075,SAN FRANCISCO,2018,68,4984,4645,9629
6075,SAN FRANCISCO,2018,69,4576,4433,9009
6075,SAN FRANCISCO,2018,70,4458,4161,8619
6075,SAN FRANCISCO,2018,71,4164,3768,7932
6075,SAN FRANCISCO,2018,72,3507,3193,6700
6075,SAN FRANCISCO,2018,73,3253,3017,6270
6075,SAN FRANCISCO,2018,74,3094,2624,5718
6075,SAN FRANCISCO,2018,75,2955,2547,5502
6075,SAN FRANCISCO,2018,76,2767,2330,5097
6075,SAN FRANCISCO,2018,77,2601,2102,4703
6075,SAN FRANCISCO,2018,78,2546,2111,4657
6075,SAN FRANCISCO,2018,79,2445,1921,4366
6075,SAN FRANCISCO,2018,80,2404,1851,4255
6075,SAN FRANCISCO,2018,81,2279,1717,3996
6075,SAN FRANCISCO,2018,82,2132,1621,3753
6075,SAN FRANCISCO,2018,83,1966,1478,3444
6075,SAN FRANCISCO,2018,84,1950,1384,3334
6075,SAN FRANCISCO,2018,85,1947,1343,3290
6075,SAN FRANCISCO,2018,86,1716,1155,2871
6075,SAN FRANCISCO,2018,87,1692,1113,2805
6075,SAN FRANCISCO,2018,88,1561,978,2539
6075,SAN FRANCISCO,2018,89,1512,825,2337
6075,SAN FRANCISCO,2018,90,1419,761,2180
6075,SAN FRANCISCO,2018,91,1120,630,1750
6075,SAN FRANCISCO,2018,92,940,437,1377
6075,SAN FRANCISCO,2018,93,790,379,1169
6075,SAN FRANCISCO,2018,94,584,272,856
6075,SAN FRANCISCO,2018,95,467,220,687
6075,SAN FRANCISCO,2018,96,346,169,515
6075,SAN FRANCISCO,2018,97,245,94,339
6075,SAN FRANCISCO,2018,98,184,55,239
6075,SAN FRANCISCO,2018,99,121,38,159
6075,SAN FRANCISCO,2018,100,192,85,277
6075,SAN FRANCISCO,2019,0,4348,4743,9091
6075,SAN FRANCISCO,2019,1,4300,4612,8912
6075,SAN FRANCISCO,2019,2,4179,4597,8776
6075,SAN FRANCISCO,2019,3,4278,4339,8617
6075,SAN FRANCISCO,2019,4,4178,4445,8623
6075,SAN FRANCISCO,2019,5,4092,4323,8415
6075,SAN FRANCISCO,2019,6,4119,4387,8506
6075,SAN FRANCISCO,2019,7,4051,4241,8292
6075,SAN FRANCISCO,2019,8,4061,4310,8371
6075,SAN FRANCISCO,2019,9,3557,3792,7349
6075,SAN FRANCISCO,2019,10,3382,3547,6929
6075,SAN FRANCISCO,2019,11,3268,3531,6799
6075,SAN FRANCISCO,2019,12,3072,3268,6340
6075,SAN FRANCISCO,2019,13,2949,2900,5849
6075,SAN FRANCISCO,2019,14,2997,2983,5980
6075,SAN FRANCISCO,2019,15,2805,2970,5775
6075,SAN FRANCISCO,2019,16,2722,2791,5513
6075,SAN FRANCISCO,2019,17,2783,2663,5446
6075,SAN FRANCISCO,2019,18,4781,4450,9231
6075,SAN FRANCISCO,2019,19,4766,4654,9420
6075,SAN FRANCISCO,2019,20,4317,4420,8737
6075,SAN FRANCISCO,2019,21,4611,4760,9371
6075,SAN FRANCISCO,2019,22,5067,4907,9974
6075,SAN FRANCISCO,2019,23,5078,5051,10129
6075,SAN FRANCISCO,2019,24,5155,5112,10267
6075,SAN FRANCISCO,2019,25,5450,5144,10594
6075,SAN FRANCISCO,2019,26,4881,4819,9700
6075,SAN FRANCISCO,2019,27,5617,5443,11060
6075,SAN FRANCISCO,2019,28,5989,5812,11801
6075,SAN FRANCISCO,2019,29,6717,6652,13369
6075,SAN FRANCISCO,2019,30,7343,6994,14337
6075,SAN FRANCISCO,2019,31,7825,7528,15353
6075,SAN FRANCISCO,2019,32,8773,8804,17577
6075,SAN FRANCISCO,2019,33,9796,9447,19243
6075,SAN FRANCISCO,2019,34,10522,10393,20915
6075,SAN FRANCISCO,2019,35,10427,10604,21031
6075,SAN FRANCISCO,2019,36,10075,10482,20557
6075,SAN FRANCISCO,2019,37,9761,9894,19655
6075,SAN FRANCISCO,2019,38,8772,9191,17963
6075,SAN FRANCISCO,2019,39,8206,8673,16879
6075,SAN FRANCISCO,2019,40,7598,8079,15677
6075,SAN FRANCISCO,2019,41,7325,7752,15077
6075,SAN FRANCISCO,2019,42,6772,7507,14279
6075,SAN FRANCISCO,2019,43,6468,7097,13565
6075,SAN FRANCISCO,2019,44,6324,7416,13740
6075,SAN FRANCISCO,2019,45,6033,7282,13315
6075,SAN FRANCISCO,2019,46,6180,7028,13208
6075,SAN FRANCISCO,2019,47,5876,6958,12834
6075,SAN FRANCISCO,2019,48,6149,7460,13609
6075,SAN FRANCISCO,2019,49,6237,7772,14009
6075,SAN FRANCISCO,2019,50,5826,6961,12787
6075,SAN FRANCISCO,2019,51,5294,6520,11814
6075,SAN FRANCISCO,2019,52,5048,6196,11244
6075,SAN FRANCISCO,2019,53,4921,6323,11244
6075,SAN FRANCISCO,2019,54,5149,6473,11622
6075,SAN FRANCISCO,2019,55,5082,6197,11279
6075,SAN FRANCISCO,2019,56,5167,6029,11196
6075,SAN FRANCISCO,2019,57,4937,5775,10712
6075,SAN FRANCISCO,2019,58,4698,5613,10311
6075,SAN FRANCISCO,2019,59,4766,5714,10480
6075,SAN FRANCISCO,2019,60,4773,5422,10195
6075,SAN FRANCISCO,2019,61,4862,5233,10095
6075,SAN FRANCISCO,2019,62,4813,5274,10087
6075,SAN FRANCISCO,2019,63,4874,4957,9831
6075,SAN FRANCISCO,2019,64,5046,5063,10109
6075,SAN FRANCISCO,2019,65,4775,4955,9730
6075,SAN FRANCISCO,2019,66,4791,4725,9516
6075,SAN FRANCISCO,2019,67,4635,4525,9160
6075,SAN FRANCISCO,2019,68,4559,4450,9009
6075,SAN FRANCISCO,2019,69,4955,4598,9553
6075,SAN FRANCISCO,2019,70,4554,4384,8938
6075,SAN FRANCISCO,2019,71,4397,4084,8481
6075,SAN FRANCISCO,2019,72,4160,3696,7856
6075,SAN FRANCISCO,2019,73,3447,3154,6601
6075,SAN FRANCISCO,2019,74,3233,2957,6190
6075,SAN FRANCISCO,2019,75,3063,2607,5670
6075,SAN FRANCISCO,2019,76,2884,2466,5350
6075,SAN FRANCISCO,2019,77,2721,2261,4982
6075,SAN FRANCISCO,2019,78,2576,2061,4637
6075,SAN FRANCISCO,2019,79,2484,2053,4537
6075,SAN FRANCISCO,2019,80,2423,1878,4301
6075,SAN FRANCISCO,2019,81,2307,1741,4048
6075,SAN FRANCISCO,2019,82,2206,1631,3837
6075,SAN FRANCISCO,2019,83,2058,1553,3611
6075,SAN FRANCISCO,2019,84,1882,1397,3279
6075,SAN FRANCISCO,2019,85,1977,1345,3322
6075,SAN FRANCISCO,2019,86,1808,1229,3037
6075,SAN FRANCISCO,2019,87,1642,1054,2696
6075,SAN FRANCISCO,2019,88,1603,997,2600
6075,SAN FRANCISCO,2019,89,1483,917,2400
6075,SAN FRANCISCO,2019,90,1414,773,2187
6075,SAN FRANCISCO,2019,91,1214,616,1830
6075,SAN FRANCISCO,2019,92,953,498,1451
6075,SAN FRANCISCO,2019,93,808,378,1186
6075,SAN FRANCISCO,2019,94,691,316,1007
6075,SAN FRANCISCO,2019,95,493,200,693
6075,SAN FRANCISCO,2019,96,365,155,520
6075,SAN FRANCISCO,2019,97,264,127,391
6075,SAN FRANCISCO,2019,98,188,70,258
6075,SAN FRANCISCO,2019,99,133,47,180
6075,SAN FRANCISCO,2019,100,218,84,302
6077,SAN JOAQUIN,2017,0,4931,5398,10329
6077,SAN JOAQUIN,2017,1,4908,5169,10077
6077,SAN JOAQUIN,2017,2,4833,5308,10141
6077,SAN JOAQUIN,2017,3,5074,5205,10279
6077,SAN JOAQUIN,2017,4,5008,5473,10481
6077,SAN JOAQUIN,2017,5,5225,5522,10747
6077,SAN JOAQUIN,2017,6,5582,5776,11358
6077,SAN JOAQUIN,2017,7,5523,5735,11258
6077,SAN JOAQUIN,2017,8,5422,5667,11089
6077,SAN JOAQUIN,2017,9,5665,5840,11505
6077,SAN JOAQUIN,2017,10,5779,5999,11778
6077,SAN JOAQUIN,2017,11,5686,5975,11661
6077,SAN JOAQUIN,2017,12,5755,6006,11761
6077,SAN JOAQUIN,2017,13,5540,5689,11229
6077,SAN JOAQUIN,2017,14,5518,5690,11208
6077,SAN JOAQUIN,2017,15,5580,6004,11584
6077,SAN JOAQUIN,2017,16,5704,6060,11764
6077,SAN JOAQUIN,2017,17,5727,6194,11921
6077,SAN JOAQUIN,2017,18,5820,6504,12324
6077,SAN JOAQUIN,2017,19,5871,6560,12431
6077,SAN JOAQUIN,2017,20,5914,6381,12295
6077,SAN JOAQUIN,2017,21,5927,6220,12147
6077,SAN JOAQUIN,2017,22,5670,6006,11676
6077,SAN JOAQUIN,2017,23,5719,6180,11899
6077,SAN JOAQUIN,2017,24,5425,6114,11539
6077,SAN JOAQUIN,2017,25,5334,5752,11086
6077,SAN JOAQUIN,2017,26,5260,5686,10946
6077,SAN JOAQUIN,2017,27,4998,5361,10359
6077,SAN JOAQUIN,2017,28,4560,5159,9719
6077,SAN JOAQUIN,2017,29,4421,4887,9308
6077,SAN JOAQUIN,2017,30,4414,4589,9003
6077,SAN JOAQUIN,2017,31,4448,4724,9172
6077,SAN JOAQUIN,2017,32,4659,4826,9485
6077,SAN JOAQUIN,2017,33,4614,4770,9384
6077,SAN JOAQUIN,2017,34,4670,5005,9675
6077,SAN JOAQUIN,2017,35,4896,4995,9891
6077,SAN JOAQUIN,2017,36,4816,4838,9654
6077,SAN JOAQUIN,2017,37,4899,4937,9836
6077,SAN JOAQUIN,2017,38,4462,4475,8937
6077,SAN JOAQUIN,2017,39,4515,4453,8968
6077,SAN JOAQUIN,2017,40,4348,4272,8620
6077,SAN JOAQUIN,2017,41,4523,4393,8916
6077,SAN JOAQUIN,2017,42,4500,4650,9150
6077,SAN JOAQUIN,2017,43,4603,4274,8877
6077,SAN JOAQUIN,2017,44,4662,4521,9183
6077,SAN JOAQUIN,2017,45,4822,4823,9645
6077,SAN JOAQUIN,2017,46,5028,4705,9733
6077,SAN JOAQUIN,2017,47,4945,4894,9839
6077,SAN JOAQUIN,2017,48,4770,4562,9332
6077,SAN JOAQUIN,2017,49,4429,4522,8951
6077,SAN JOAQUIN,2017,50,4360,4402,8762
6077,SAN JOAQUIN,2017,51,4471,4634,9105
6077,SAN JOAQUIN,2017,52,4828,4759,9587
6077,SAN JOAQUIN,2017,53,4831,5133,9964
6077,SAN JOAQUIN,2017,54,5128,5058,10186
6077,SAN JOAQUIN,2017,55,5199,5062,10261
6077,SAN JOAQUIN,2017,56,5069,4870,9939
6077,SAN JOAQUIN,2017,57,4911,4918,9829
6077,SAN JOAQUIN,2017,58,4623,4418,9041
6077,SAN JOAQUIN,2017,59,4375,4351,8726
6077,SAN JOAQUIN,2017,60,3965,4124,8089
6077,SAN JOAQUIN,2017,61,4117,3762,7879
6077,SAN JOAQUIN,2017,62,4174,3861,8035
6077,SAN JOAQUIN,2017,63,3995,3590,7585
6077,SAN JOAQUIN,2017,64,3772,3451,7223
6077,SAN JOAQUIN,2017,65,3708,3321,7029
6077,SAN JOAQUIN,2017,66,3561,3003,6564
6077,SAN JOAQUIN,2017,67,3478,3123,6601
6077,SAN JOAQUIN,2017,68,3293,2858,6151
6077,SAN JOAQUIN,2017,69,3179,2825,6004
6077,SAN JOAQUIN,2017,70,3129,2718,5847
6077,SAN JOAQUIN,2017,71,2561,2298,4859
6077,SAN JOAQUIN,2017,72,2460,2135,4595
6077,SAN JOAQUIN,2017,73,2356,2049,4405
6077,SAN JOAQUIN,2017,74,2348,1851,4199
6077,SAN JOAQUIN,2017,75,2039,1732,3771
6077,SAN JOAQUIN,2017,76,1884,1546,3430
6077,SAN JOAQUIN,2017,77,1849,1444,3293
6077,SAN JOAQUIN,2017,78,1595,1233,2828
6077,SAN JOAQUIN,2017,79,1497,1154,2651
6077,SAN JOAQUIN,2017,80,1350,1062,2412
6077,SAN JOAQUIN,2017,81,1317,927,2244
6077,SAN JOAQUIN,2017,82,1206,834,2040
6077,SAN JOAQUIN,2017,83,1090,759,1849
6077,SAN JOAQUIN,2017,84,1032,642,1674
6077,SAN JOAQUIN,2017,85,1087,617,1704
6077,SAN JOAQUIN,2017,86,962,626,1588
6077,SAN JOAQUIN,2017,87,858,528,1386
6077,SAN JOAQUIN,2017,88,782,480,1262
6077,SAN JOAQUIN,2017,89,689,332,1021
6077,SAN JOAQUIN,2017,90,693,361,1054
6077,SAN JOAQUIN,2017,91,580,267,847
6077,SAN JOAQUIN,2017,92,421,217,638
6077,SAN JOAQUIN,2017,93,338,154,492
6077,SAN JOAQUIN,2017,94,276,104,380
6077,SAN JOAQUIN,2017,95,210,121,331
6077,SAN JOAQUIN,2017,96,143,43,186
6077,SAN JOAQUIN,2017,97,88,35,123
6077,SAN JOAQUIN,2017,98,66,23,89
6077,SAN JOAQUIN,2017,99,39,15,54
6077,SAN JOAQUIN,2017,100,27,13,40
6077,SAN JOAQUIN,2018,0,4970,5475,10445
6077,SAN JOAQUIN,2018,1,4907,5370,10277
6077,SAN JOAQUIN,2018,2,5005,5350,10355
6077,SAN JOAQUIN,2018,3,4951,5418,10369
6077,SAN JOAQUIN,2018,4,5187,5284,10471
6077,SAN JOAQUIN,2018,5,5102,5540,10642
6077,SAN JOAQUIN,2018,6,5295,5595,10890
6077,SAN JOAQUIN,2018,7,5651,5828,11479
6077,SAN JOAQUIN,2018,8,5587,5780,11367
6077,SAN JOAQUIN,2018,9,5484,5717,11201
6077,SAN JOAQUIN,2018,10,5699,5902,11601
6077,SAN JOAQUIN,2018,11,5811,6031,11842
6077,SAN JOAQUIN,2018,12,5747,6037,11784
6077,SAN JOAQUIN,2018,13,5807,6064,11871
6077,SAN JOAQUIN,2018,14,5560,5770,11330
6077,SAN JOAQUIN,2018,15,5610,5795,11405
6077,SAN JOAQUIN,2018,16,5653,6104,11757
6077,SAN JOAQUIN,2018,17,5804,6183,11987
6077,SAN JOAQUIN,2018,18,5949,6563,12512
6077,SAN JOAQUIN,2018,19,5884,6636,12520
6077,SAN JOAQUIN,2018,20,5788,6431,12219
6077,SAN JOAQUIN,2018,21,5921,6321,12242
6077,SAN JOAQUIN,2018,22,5962,6202,12164
6077,SAN JOAQUIN,2018,23,5636,5995,11631
6077,SAN JOAQUIN,2018,24,5742,6164,11906
6077,SAN JOAQUIN,2018,25,5323,6069,11392
6077,SAN JOAQUIN,2018,26,5327,5738,11065
6077,SAN JOAQUIN,2018,27,5260,5660,10920
6077,SAN JOAQUIN,2018,28,4999,5378,10377
6077,SAN JOAQUIN,2018,29,4567,5148,9715
6077,SAN JOAQUIN,2018,30,4416,4830,9246
6077,SAN JOAQUIN,2018,31,4531,4647,9178
6077,SAN JOAQUIN,2018,32,4524,4812,9336
6077,SAN JOAQUIN,2018,33,4728,4928,9656
6077,SAN JOAQUIN,2018,34,4656,4814,9470
6077,SAN JOAQUIN,2018,35,4757,5027,9784
6077,SAN JOAQUIN,2018,36,4875,4980,9855
6077,SAN JOAQUIN,2018,37,4813,4837,9650
6077,SAN JOAQUIN,2018,38,4901,4982,9883
6077,SAN JOAQUIN,2018,39,4448,4454,8902
6077,SAN JOAQUIN,2018,40,4521,4440,8961
6077,SAN JOAQUIN,2018,41,4425,4353,8778
6077,SAN JOAQUIN,2018,42,4571,4453,9024
6077,SAN JOAQUIN,2018,43,4561,4745,9306
6077,SAN JOAQUIN,2018,44,4632,4318,8950
6077,SAN JOAQUIN,2018,45,4802,4565,9367
6077,SAN JOAQUIN,2018,46,4800,4788,9588
6077,SAN JOAQUIN,2018,47,5020,4680,9700
6077,SAN JOAQUIN,2018,48,4936,4883,9819
6077,SAN JOAQUIN,2018,49,4752,4542,9294
6077,SAN JOAQUIN,2018,50,4440,4482,8922
6077,SAN JOAQUIN,2018,51,4430,4604,9034
6077,SAN JOAQUIN,2018,52,4685,4638,9323
6077,SAN JOAQUIN,2018,53,4880,4934,9814
6077,SAN JOAQUIN,2018,54,4906,5197,10103
6077,SAN JOAQUIN,2018,55,5148,5124,10272
6077,SAN JOAQUIN,2018,56,5154,4974,10128
6077,SAN JOAQUIN,2018,57,5014,4794,9808
6077,SAN JOAQUIN,2018,58,4845,4855,9700
6077,SAN JOAQUIN,2018,59,4591,4345,8936
6077,SAN JOAQUIN,2018,60,4328,4259,8587
6077,SAN JOAQUIN,2018,61,3998,4113,8111
6077,SAN JOAQUIN,2018,62,4126,3755,7881
6077,SAN JOAQUIN,2018,63,4180,3844,8024
6077,SAN JOAQUIN,2018,64,3982,3538,7520
6077,SAN JOAQUIN,2018,65,3769,3388,7157
6077,SAN JOAQUIN,2018,66,3711,3266,6977
6077,SAN JOAQUIN,2018,67,3521,2971,6492
6077,SAN JOAQUIN,2018,68,3429,3074,6503
6077,SAN JOAQUIN,2018,69,3250,2793,6043
6077,SAN JOAQUIN,2018,70,3140,2785,5925
6077,SAN JOAQUIN,2018,71,3104,2663,5767
6077,SAN JOAQUIN,2018,72,2540,2246,4786
6077,SAN JOAQUIN,2018,73,2427,2075,4502
6077,SAN JOAQUIN,2018,74,2338,2015,4353
6077,SAN JOAQUIN,2018,75,2332,1830,4162
6077,SAN JOAQUIN,2018,76,1971,1646,3617
6077,SAN JOAQUIN,2018,77,1816,1470,3286
6077,SAN JOAQUIN,2018,78,1802,1380,3182
6077,SAN JOAQUIN,2018,79,1564,1178,2742
6077,SAN JOAQUIN,2018,80,1474,1105,2579
6077,SAN JOAQUIN,2018,81,1277,989,2266
6077,SAN JOAQUIN,2018,82,1257,867,2124
6077,SAN JOAQUIN,2018,83,1139,768,1907
6077,SAN JOAQUIN,2018,84,1039,696,1735
6077,SAN JOAQUIN,2018,85,1067,607,1674
6077,SAN JOAQUIN,2018,86,974,559,1533
6077,SAN JOAQUIN,2018,87,885,561,1446
6077,SAN JOAQUIN,2018,88,778,480,1258
6077,SAN JOAQUIN,2018,89,721,395,1116
6077,SAN JOAQUIN,2018,90,627,289,916
6077,SAN JOAQUIN,2018,91,583,303,886
6077,SAN JOAQUIN,2018,92,468,224,692
6077,SAN JOAQUIN,2018,93,350,168,518
6077,SAN JOAQUIN,2018,94,262,123,385
6077,SAN JOAQUIN,2018,95,243,75,318
6077,SAN JOAQUIN,2018,96,153,87,240
6077,SAN JOAQUIN,2018,97,98,25,123
6077,SAN JOAQUIN,2018,98,74,25,99
6077,SAN JOAQUIN,2018,99,50,19,69
6077,SAN JOAQUIN,2018,100,40,19,59
6077,SAN JOAQUIN,2019,0,4991,5555,10546
6077,SAN JOAQUIN,2019,1,4952,5439,10391
6077,SAN JOAQUIN,2019,2,4995,5532,10527
6077,SAN JOAQUIN,2019,3,5133,5463,10596
6077,SAN JOAQUIN,2019,4,5054,5498,10552
6077,SAN JOAQUIN,2019,5,5294,5367,10661
6077,SAN JOAQUIN,2019,6,5154,5618,10772
6077,SAN JOAQUIN,2019,7,5361,5667,11028
6077,SAN JOAQUIN,2019,8,5717,5857,11574
6077,SAN JOAQUIN,2019,9,5645,5833,11478
6077,SAN JOAQUIN,2019,10,5520,5786,11306
6077,SAN JOAQUIN,2019,11,5740,5948,11688
6077,SAN JOAQUIN,2019,12,5868,6083,11951
6077,SAN JOAQUIN,2019,13,5811,6099,11910
6077,SAN JOAQUIN,2019,14,5821,6128,11949
6077,SAN JOAQUIN,2019,15,5641,5871,11512
6077,SAN JOAQUIN,2019,16,5671,5888,11559
6077,SAN JOAQUIN,2019,17,5740,6236,11976
6077,SAN JOAQUIN,2019,18,6030,6549,12579
6077,SAN JOAQUIN,2019,19,6038,6704,12742
6077,SAN JOAQUIN,2019,20,5802,6499,12301
6077,SAN JOAQUIN,2019,21,5796,6374,12170
6077,SAN JOAQUIN,2019,22,5953,6300,12253
6077,SAN JOAQUIN,2019,23,5922,6193,12115
6077,SAN JOAQUIN,2019,24,5660,5981,11641
6077,SAN JOAQUIN,2019,25,5639,6108,11747
6077,SAN JOAQUIN,2019,26,5319,6055,11374
6077,SAN JOAQUIN,2019,27,5328,5714,11042
6077,SAN JOAQUIN,2019,28,5261,5683,10944
6077,SAN JOAQUIN,2019,29,5006,5371,10377
6077,SAN JOAQUIN,2019,30,4562,5090,9652
6077,SAN JOAQUIN,2019,31,4531,4901,9432
6077,SAN JOAQUIN,2019,32,4596,4732,9328
6077,SAN JOAQUIN,2019,33,4595,4930,9525
6077,SAN JOAQUIN,2019,34,4761,4971,9732
6077,SAN JOAQUIN,2019,35,4738,4843,9581
6077,SAN JOAQUIN,2019,36,4739,5015,9754
6077,SAN JOAQUIN,2019,37,4876,4988,9864
6077,SAN JOAQUIN,2019,38,4820,4879,9699
6077,SAN JOAQUIN,2019,39,4890,4959,9849
6077,SAN JOAQUIN,2019,40,4452,4440,8892
6077,SAN JOAQUIN,2019,41,4597,4507,9104
6077,SAN JOAQUIN,2019,42,4470,4390,8860
6077,SAN JOAQUIN,2019,43,4656,4553,9209
6077,SAN JOAQUIN,2019,44,4594,4767,9361
6077,SAN JOAQUIN,2019,45,4767,4391,9158
6077,SAN JOAQUIN,2019,46,4791,4528,9319
6077,SAN JOAQUIN,2019,47,4788,4771,9559
6077,SAN JOAQUIN,2019,48,5011,4658,9669
6077,SAN JOAQUIN,2019,49,4918,4856,9774
6077,SAN JOAQUIN,2019,50,4767,4497,9264
6077,SAN JOAQUIN,2019,51,4492,4666,9158
6077,SAN JOAQUIN,2019,52,4614,4629,9243
6077,SAN JOAQUIN,2019,53,4753,4828,9581
6077,SAN JOAQUIN,2019,54,4955,5019,9974
6077,SAN JOAQUIN,2019,55,4936,5247,10183
6077,SAN JOAQUIN,2019,56,5090,5056,10146
6077,SAN JOAQUIN,2019,57,5108,4902,10010
6077,SAN JOAQUIN,2019,58,4955,4736,9691
6077,SAN JOAQUIN,2019,59,4822,4788,9610
6077,SAN JOAQUIN,2019,60,4539,4253,8792
6077,SAN JOAQUIN,2019,61,4342,4256,8598
6077,SAN JOAQUIN,2019,62,4013,4092,8105
6077,SAN JOAQUIN,2019,63,4136,3729,7865
6077,SAN JOAQUIN,2019,64,4166,3795,7961
6077,SAN JOAQUIN,2019,65,3977,3497,7474
6077,SAN JOAQUIN,2019,66,3778,3352,7130
6077,SAN JOAQUIN,2019,67,3682,3213,6895
6077,SAN JOAQUIN,2019,68,3500,2937,6437
6077,SAN JOAQUIN,2019,69,3384,3013,6397
6077,SAN JOAQUIN,2019,70,3216,2772,5988
6077,SAN JOAQUIN,2019,71,3099,2733,5832
6077,SAN JOAQUIN,2019,72,3057,2590,5647
6077,SAN JOAQUIN,2019,73,2509,2202,4711
6077,SAN JOAQUIN,2019,74,2407,2029,4436
6077,SAN JOAQUIN,2019,75,2328,1999,4327
6077,SAN JOAQUIN,2019,76,2266,1764,4030
6077,SAN JOAQUIN,2019,77,1914,1584,3498
6077,SAN JOAQUIN,2019,78,1757,1410,3167
6077,SAN JOAQUIN,2019,79,1774,1327,3101
6077,SAN JOAQUIN,2019,80,1536,1140,2676
6077,SAN JOAQUIN,2019,81,1415,1023,2438
6077,SAN JOAQUIN,2019,82,1229,914,2143
6077,SAN JOAQUIN,2019,83,1184,804,1988
6077,SAN JOAQUIN,2019,84,1081,711,1792
6077,SAN JOAQUIN,2019,85,1098,654,1752
6077,SAN JOAQUIN,2019,86,956,559,1515
6077,SAN JOAQUIN,2019,87,900,495,1395
6077,SAN JOAQUIN,2019,88,800,513,1313
6077,SAN JOAQUIN,2019,89,697,419,1116
6077,SAN JOAQUIN,2019,90,659,367,1026
6077,SAN JOAQUIN,2019,91,514,233,747
6077,SAN JOAQUIN,2019,92,475,233,708
6077,SAN JOAQUIN,2019,93,406,182,588
6077,SAN JOAQUIN,2019,94,306,123,429
6077,SAN JOAQUIN,2019,95,236,101,337
6077,SAN JOAQUIN,2019,96,178,65,243
6077,SAN JOAQUIN,2019,97,86,62,148
6077,SAN JOAQUIN,2019,98,78,18,96
6077,SAN JOAQUIN,2019,99,61,15,76
6077,SAN JOAQUIN,2019,100,60,26,86
6079,SAN LUIS OBISPO,2017,0,1306,1411,2717
6079,SAN LUIS OBISPO,2017,1,1318,1334,2652
6079,SAN LUIS OBISPO,2017,2,1225,1342,2567
6079,SAN LUIS OBISPO,2017,3,1317,1302,2619
6079,SAN LUIS OBISPO,2017,4,1281,1320,2601
6079,SAN LUIS OBISPO,2017,5,1294,1304,2598
6079,SAN LUIS OBISPO,2017,6,1247,1370,2617
6079,SAN LUIS OBISPO,2017,7,1292,1360,2652
6079,SAN LUIS OBISPO,2017,8,1289,1315,2604
6079,SAN LUIS OBISPO,2017,9,1365,1346,2711
6079,SAN LUIS OBISPO,2017,10,1333,1497,2830
6079,SAN LUIS OBISPO,2017,11,1381,1462,2843
6079,SAN LUIS OBISPO,2017,12,1464,1484,2948
6079,SAN LUIS OBISPO,2017,13,1416,1536,2952
6079,SAN LUIS OBISPO,2017,14,1421,1523,2944
6079,SAN LUIS OBISPO,2017,15,1388,1558,2946
6079,SAN LUIS OBISPO,2017,16,1491,1562,3053
6079,SAN LUIS OBISPO,2017,17,1563,1611,3174
6079,SAN LUIS OBISPO,2017,18,2989,3448,6437
6079,SAN LUIS OBISPO,2017,19,2919,3105,6024
6079,SAN LUIS OBISPO,2017,20,2969,3397,6366
6079,SAN LUIS OBISPO,2017,21,3087,3527,6614
6079,SAN LUIS OBISPO,2017,22,2386,2824,5210
6079,SAN LUIS OBISPO,2017,23,1952,2330,4282
6079,SAN LUIS OBISPO,2017,24,1619,1904,3523
6079,SAN LUIS OBISPO,2017,25,1728,2159,3887
6079,SAN LUIS OBISPO,2017,26,1680,2200,3880
6079,SAN LUIS OBISPO,2017,27,1692,2198,3890
6079,SAN LUIS OBISPO,2017,28,1474,1943,3417
6079,SAN LUIS OBISPO,2017,29,1259,1725,2984
6079,SAN LUIS OBISPO,2017,30,1235,1747,2982
6079,SAN LUIS OBISPO,2017,31,1186,1664,2850
6079,SAN LUIS OBISPO,2017,32,1315,1654,2969
6079,SAN LUIS OBISPO,2017,33,1437,1740,3177
6079,SAN LUIS OBISPO,2017,34,1491,1845,3336
6079,SAN LUIS OBISPO,2017,35,1509,1812,3321
6079,SAN LUIS OBISPO,2017,36,1423,1815,3238
6079,SAN LUIS OBISPO,2017,37,1468,1767,3235
6079,SAN LUIS OBISPO,2017,38,1350,1632,2982
6079,SAN LUIS OBISPO,2017,39,1304,1617,2921
6079,SAN LUIS OBISPO,2017,40,1241,1563,2804
6079,SAN LUIS OBISPO,2017,41,1234,1448,2682
6079,SAN LUIS OBISPO,2017,42,1191,1526,2717
6079,SAN LUIS OBISPO,2017,43,1173,1464,2637
6079,SAN LUIS OBISPO,2017,44,1232,1433,2665
6079,SAN LUIS OBISPO,2017,45,1258,1459,2717
6079,SAN LUIS OBISPO,2017,46,1391,1577,2968
6079,SAN LUIS OBISPO,2017,47,1532,1748,3280
6079,SAN LUIS OBISPO,2017,48,1397,1639,3036
6079,SAN LUIS OBISPO,2017,49,1433,1582,3015
6079,SAN LUIS OBISPO,2017,50,1453,1617,3070
6079,SAN LUIS OBISPO,2017,51,1397,1618,3015
6079,SAN LUIS OBISPO,2017,52,1618,1647,3265
6079,SAN LUIS OBISPO,2017,53,1797,1812,3609
6079,SAN LUIS OBISPO,2017,54,1798,1807,3605
6079,SAN LUIS OBISPO,2017,55,1863,1803,3666
6079,SAN LUIS OBISPO,2017,56,1953,1846,3799
6079,SAN LUIS OBISPO,2017,57,2023,1946,3969
6079,SAN LUIS OBISPO,2017,58,1982,1866,3848
6079,SAN LUIS OBISPO,2017,59,2201,1930,4131
6079,SAN LUIS OBISPO,2017,60,2256,1825,4081
6079,SAN LUIS OBISPO,2017,61,2209,1966,4175
6079,SAN LUIS OBISPO,2017,62,2320,1978,4298
6079,SAN LUIS OBISPO,2017,63,2187,2061,4248
6079,SAN LUIS OBISPO,2017,64,2260,2037,4297
6079,SAN LUIS OBISPO,2017,65,2202,2063,4265
6079,SAN LUIS OBISPO,2017,66,2078,1949,4027
6079,SAN LUIS OBISPO,2017,67,2042,1940,3982
6079,SAN LUIS OBISPO,2017,68,1975,1878,3853
6079,SAN LUIS OBISPO,2017,69,1905,1834,3739
6079,SAN LUIS OBISPO,2017,70,1783,1848,3631
6079,SAN LUIS OBISPO,2017,71,1446,1355,2801
6079,SAN LUIS OBISPO,2017,72,1448,1285,2733
6079,SAN LUIS OBISPO,2017,73,1358,1219,2577
6079,SAN LUIS OBISPO,2017,74,1376,1202,2578
6079,SAN LUIS OBISPO,2017,75,1230,1078,2308
6079,SAN LUIS OBISPO,2017,76,1052,913,1965
6079,SAN LUIS OBISPO,2017,77,1085,871,1956
6079,SAN LUIS OBISPO,2017,78,864,793,1657
6079,SAN LUIS OBISPO,2017,79,877,717,1594
6079,SAN LUIS OBISPO,2017,80,844,691,1535
6079,SAN LUIS OBISPO,2017,81,770,588,1358
6079,SAN LUIS OBISPO,2017,82,762,585,1347
6079,SAN LUIS OBISPO,2017,83,681,517,1198
6079,SAN LUIS OBISPO,2017,84,596,472,1068
6079,SAN LUIS OBISPO,2017,85,601,488,1089
6079,SAN LUIS OBISPO,2017,86,650,433,1083
6079,SAN LUIS OBISPO,2017,87,539,387,926
6079,SAN LUIS OBISPO,2017,88,523,340,863
6079,SAN LUIS OBISPO,2017,89,433,285,718
6079,SAN LUIS OBISPO,2017,90,410,249,659
6079,SAN LUIS OBISPO,2017,91,403,221,624
6079,SAN LUIS OBISPO,2017,92,288,126,414
6079,SAN LUIS OBISPO,2017,93,201,108,309
6079,SAN LUIS OBISPO,2017,94,182,84,266
6079,SAN LUIS OBISPO,2017,95,169,68,237
6079,SAN LUIS OBISPO,2017,96,84,42,126
6079,SAN LUIS OBISPO,2017,97,55,32,87
6079,SAN LUIS OBISPO,2017,98,30,15,45
6079,SAN LUIS OBISPO,2017,99,19,9,28
6079,SAN LUIS OBISPO,2017,100,23,3,26
6079,SAN LUIS OBISPO,2018,0,1285,1472,2757
6079,SAN LUIS OBISPO,2018,1,1302,1405,2707
6079,SAN LUIS OBISPO,2018,2,1313,1327,2640
6079,SAN LUIS OBISPO,2018,3,1228,1343,2571
6079,SAN LUIS OBISPO,2018,4,1315,1298,2613
6079,SAN LUIS OBISPO,2018,5,1276,1313,2589
6079,SAN LUIS OBISPO,2018,6,1309,1311,2620
6079,SAN LUIS OBISPO,2018,7,1250,1381,2631
6079,SAN LUIS OBISPO,2018,8,1302,1376,2678
6079,SAN LUIS OBISPO,2018,9,1298,1321,2619
6079,SAN LUIS OBISPO,2018,10,1371,1365,2736
6079,SAN LUIS OBISPO,2018,11,1348,1513,2861
6079,SAN LUIS OBISPO,2018,12,1393,1489,2882
6079,SAN LUIS OBISPO,2018,13,1492,1504,2996
6079,SAN LUIS OBISPO,2018,14,1427,1546,2973
6079,SAN LUIS OBISPO,2018,15,1450,1566,3016
6079,SAN LUIS OBISPO,2018,16,1414,1585,2999
6079,SAN LUIS OBISPO,2018,17,1556,1632,3188
6079,SAN LUIS OBISPO,2018,18,3064,3451,6515
6079,SAN LUIS OBISPO,2018,19,2877,3177,6054
6079,SAN LUIS OBISPO,2018,20,2985,3231,6216
6079,SAN LUIS OBISPO,2018,21,3055,3676,6731
6079,SAN LUIS OBISPO,2018,22,2697,3034,5731
6079,SAN LUIS OBISPO,2018,23,1953,2316,4269
6079,SAN LUIS OBISPO,2018,24,1714,1986,3700
6079,SAN LUIS OBISPO,2018,25,1430,1760,3190
6079,SAN LUIS OBISPO,2018,26,1507,1884,3391
6079,SAN LUIS OBISPO,2018,27,1646,2194,3840
6079,SAN LUIS OBISPO,2018,28,1678,2141,3819
6079,SAN LUIS OBISPO,2018,29,1477,1929,3406
6079,SAN LUIS OBISPO,2018,30,1239,1756,2995
6079,SAN LUIS OBISPO,2018,31,1259,1725,2984
6079,SAN LUIS OBISPO,2018,32,1165,1647,2812
6079,SAN LUIS OBISPO,2018,33,1350,1696,3046
6079,SAN LUIS OBISPO,2018,34,1420,1752,3172
6079,SAN LUIS OBISPO,2018,35,1517,1833,3350
6079,SAN LUIS OBISPO,2018,36,1456,1775,3231
6079,SAN LUIS OBISPO,2018,37,1420,1844,3264
6079,SAN LUIS OBISPO,2018,38,1459,1777,3236
6079,SAN LUIS OBISPO,2018,39,1347,1605,2952
6079,SAN LUIS OBISPO,2018,40,1304,1674,2978
6079,SAN LUIS OBISPO,2018,41,1234,1506,2740
6079,SAN LUIS OBISPO,2018,42,1226,1465,2691
6079,SAN LUIS OBISPO,2018,43,1191,1554,2745
6079,SAN LUIS OBISPO,2018,44,1171,1426,2597
6079,SAN LUIS OBISPO,2018,45,1225,1451,2676
6079,SAN LUIS OBISPO,2018,46,1259,1445,2704
6079,SAN LUIS OBISPO,2018,47,1410,1613,3023
6079,SAN LUIS OBISPO,2018,48,1526,1721,3247
6079,SAN LUIS OBISPO,2018,49,1404,1669,3073
6079,SAN LUIS OBISPO,2018,50,1443,1543,2986
6079,SAN LUIS OBISPO,2018,51,1446,1613,3059
6079,SAN LUIS OBISPO,2018,52,1409,1574,2983
6079,SAN LUIS OBISPO,2018,53,1616,1681,3297
6079,SAN LUIS OBISPO,2018,54,1798,1795,3593
6079,SAN LUIS OBISPO,2018,55,1810,1743,3553
6079,SAN LUIS OBISPO,2018,56,1878,1826,3704
6079,SAN LUIS OBISPO,2018,57,1962,1841,3803
6079,SAN LUIS OBISPO,2018,58,2012,1912,3924
6079,SAN LUIS OBISPO,2018,59,2003,1889,3892
6079,SAN LUIS OBISPO,2018,60,2213,1870,4083
6079,SAN LUIS OBISPO,2018,61,2311,1870,4181
6079,SAN LUIS OBISPO,2018,62,2229,1978,4207
6079,SAN LUIS OBISPO,2018,63,2350,1950,4300
6079,SAN LUIS OBISPO,2018,64,2216,2165,4381
6079,SAN LUIS OBISPO,2018,65,2288,2038,4326
6079,SAN LUIS OBISPO,2018,66,2197,2049,4246
6079,SAN LUIS OBISPO,2018,67,2097,1948,4045
6079,SAN LUIS OBISPO,2018,68,2038,1920,3958
6079,SAN LUIS OBISPO,2018,69,1973,1863,3836
6079,SAN LUIS OBISPO,2018,70,1896,1801,3697
6079,SAN LUIS OBISPO,2018,71,1776,1832,3608
6079,SAN LUIS OBISPO,2018,72,1431,1340,2771
6079,SAN LUIS OBISPO,2018,73,1469,1258,2727
6079,SAN LUIS OBISPO,2018,74,1347,1204,2551
6079,SAN LUIS OBISPO,2018,75,1374,1204,2578
6079,SAN LUIS OBISPO,2018,76,1204,1049,2253
6079,SAN LUIS OBISPO,2018,77,1020,876,1896
6079,SAN LUIS OBISPO,2018,78,1073,847,1920
6079,SAN LUIS OBISPO,2018,79,847,777,1624
6079,SAN LUIS OBISPO,2018,80,880,701,1581
6079,SAN LUIS OBISPO,2018,81,803,647,1450
6079,SAN LUIS OBISPO,2018,82,730,566,1296
6079,SAN LUIS OBISPO,2018,83,746,548,1294
6079,SAN LUIS OBISPO,2018,84,641,511,1152
6079,SAN LUIS OBISPO,2018,85,594,447,1041
6079,SAN LUIS OBISPO,2018,86,570,438,1008
6079,SAN LUIS OBISPO,2018,87,629,382,1011
6079,SAN LUIS OBISPO,2018,88,488,348,836
6079,SAN LUIS OBISPO,2018,89,469,309,778
6079,SAN LUIS OBISPO,2018,90,392,258,650
6079,SAN LUIS OBISPO,2018,91,360,199,559
6079,SAN LUIS OBISPO,2018,92,340,184,524
6079,SAN LUIS OBISPO,2018,93,232,94,326
6079,SAN LUIS OBISPO,2018,94,174,82,256
6079,SAN LUIS OBISPO,2018,95,141,66,207
6079,SAN LUIS OBISPO,2018,96,128,38,166
6079,SAN LUIS OBISPO,2018,97,55,26,81
6079,SAN LUIS OBISPO,2018,98,41,19,60
6079,SAN LUIS OBISPO,2018,99,18,10,28
6079,SAN LUIS OBISPO,2018,100,29,9,38
6079,SAN LUIS OBISPO,2019,0,1169,1373,2542
6079,SAN LUIS OBISPO,2019,1,1278,1460,2738
6079,SAN LUIS OBISPO,2019,2,1299,1398,2697
6079,SAN LUIS OBISPO,2019,3,1313,1328,2641
6079,SAN LUIS OBISPO,2019,4,1227,1339,2566
6079,SAN LUIS OBISPO,2019,5,1311,1297,2608
6079,SAN LUIS OBISPO,2019,6,1289,1322,2611
6079,SAN LUIS OBISPO,2019,7,1311,1326,2637
6079,SAN LUIS OBISPO,2019,8,1264,1401,2665
6079,SAN LUIS OBISPO,2019,9,1308,1383,2691
6079,SAN LUIS OBISPO,2019,10,1301,1336,2637
6079,SAN LUIS OBISPO,2019,11,1376,1389,2765
6079,SAN LUIS OBISPO,2019,12,1365,1541,2906
6079,SAN LUIS OBISPO,2019,13,1416,1508,2924
6079,SAN LUIS OBISPO,2019,14,1505,1513,3018
6079,SAN LUIS OBISPO,2019,15,1457,1590,3047
6079,SAN LUIS OBISPO,2019,16,1476,1585,3061
6079,SAN LUIS OBISPO,2019,17,1477,1661,3138
6079,SAN LUIS OBISPO,2019,18,3069,3472,6541
6079,SAN LUIS OBISPO,2019,19,2954,3193,6147
6079,SAN LUIS OBISPO,2019,20,2924,3303,6227
6079,SAN LUIS OBISPO,2019,21,3075,3515,6590
6079,SAN LUIS OBISPO,2019,22,2662,3185,5847
6079,SAN LUIS OBISPO,2019,23,2268,2533,4801
6079,SAN LUIS OBISPO,2019,24,1712,1970,3682
6079,SAN LUIS OBISPO,2019,25,1528,1830,3358
6079,SAN LUIS OBISPO,2019,26,1213,1504,2717
6079,SAN LUIS OBISPO,2019,27,1464,1882,3346
6079,SAN LUIS OBISPO,2019,28,1627,2141,3768
6079,SAN LUIS OBISPO,2019,29,1680,2128,3808
6079,SAN LUIS OBISPO,2019,30,1454,1951,3405
6079,SAN LUIS OBISPO,2019,31,1258,1743,3001
6079,SAN LUIS OBISPO,2019,32,1230,1716,2946
6079,SAN LUIS OBISPO,2019,33,1203,1685,2888
6079,SAN LUIS OBISPO,2019,34,1331,1709,3040
6079,SAN LUIS OBISPO,2019,35,1446,1742,3188
6079,SAN LUIS OBISPO,2019,36,1472,1795,3267
6079,SAN LUIS OBISPO,2019,37,1455,1801,3256
6079,SAN LUIS OBISPO,2019,38,1404,1854,3258
6079,SAN LUIS OBISPO,2019,39,1460,1748,3208
6079,SAN LUIS OBISPO,2019,40,1344,1663,3007
6079,SAN LUIS OBISPO,2019,41,1300,1615,2915
6079,SAN LUIS OBISPO,2019,42,1226,1519,2745
6079,SAN LUIS OBISPO,2019,43,1226,1490,2716
6079,SAN LUIS OBISPO,2019,44,1189,1513,2702
6079,SAN LUIS OBISPO,2019,45,1165,1446,2611
6079,SAN LUIS OBISPO,2019,46,1233,1434,2667
6079,SAN LUIS OBISPO,2019,47,1276,1471,2747
6079,SAN LUIS OBISPO,2019,48,1403,1589,2992
6079,SAN LUIS OBISPO,2019,49,1532,1748,3280
6079,SAN LUIS OBISPO,2019,50,1423,1633,3056
6079,SAN LUIS OBISPO,2019,51,1434,1541,2975
6079,SAN LUIS OBISPO,2019,52,1465,1575,3040
6079,SAN LUIS OBISPO,2019,53,1410,1597,3007
6079,SAN LUIS OBISPO,2019,54,1626,1656,3282
6079,SAN LUIS OBISPO,2019,55,1804,1723,3527
6079,SAN LUIS OBISPO,2019,56,1821,1760,3581
6079,SAN LUIS OBISPO,2019,57,1891,1802,3693
6079,SAN LUIS OBISPO,2019,58,1964,1818,3782
6079,SAN LUIS OBISPO,2019,59,2020,1932,3952
6079,SAN LUIS OBISPO,2019,60,2019,1836,3855
6079,SAN LUIS OBISPO,2019,61,2270,1923,4193
6079,SAN LUIS OBISPO,2019,62,2351,1883,4234
6079,SAN LUIS OBISPO,2019,63,2267,1945,4212
6079,SAN LUIS OBISPO,2019,64,2378,2048,4426
6079,SAN LUIS OBISPO,2019,65,2233,2165,4398
6079,SAN LUIS OBISPO,2019,66,2279,2042,4321
6079,SAN LUIS OBISPO,2019,67,2207,2041,4248
6079,SAN LUIS OBISPO,2019,68,2094,1940,4034
6079,SAN LUIS OBISPO,2019,69,2040,1912,3952
6079,SAN LUIS OBISPO,2019,70,1971,1834,3805
6079,SAN LUIS OBISPO,2019,71,1881,1791,3672
6079,SAN LUIS OBISPO,2019,72,1766,1801,3567
6079,SAN LUIS OBISPO,2019,73,1443,1321,2764
6079,SAN LUIS OBISPO,2019,74,1468,1247,2715
6079,SAN LUIS OBISPO,2019,75,1345,1210,2555
6079,SAN LUIS OBISPO,2019,76,1356,1163,2519
6079,SAN LUIS OBISPO,2019,77,1173,1008,2181
6079,SAN LUIS OBISPO,2019,78,1000,853,1853
6079,SAN LUIS OBISPO,2019,79,1046,828,1874
6079,SAN LUIS OBISPO,2019,80,850,753,1603
6079,SAN LUIS OBISPO,2019,81,845,671,1516
6079,SAN LUIS OBISPO,2019,82,766,625,1391
6079,SAN LUIS OBISPO,2019,83,712,524,1236
6079,SAN LUIS OBISPO,2019,84,695,533,1228
6079,SAN LUIS OBISPO,2019,85,637,493,1130
6079,SAN LUIS OBISPO,2019,86,562,406,968
6079,SAN LUIS OBISPO,2019,87,539,397,936
6079,SAN LUIS OBISPO,2019,88,569,346,915
6079,SAN LUIS OBISPO,2019,89,443,303,746
6079,SAN LUIS OBISPO,2019,90,421,277,698
6079,SAN LUIS OBISPO,2019,91,336,210,546
6079,SAN LUIS OBISPO,2019,92,312,167,479
6079,SAN LUIS OBISPO,2019,93,275,136,411
6079,SAN LUIS OBISPO,2019,94,195,77,272
6079,SAN LUIS OBISPO,2019,95,137,65,202
6079,SAN LUIS OBISPO,2019,96,107,36,143
6079,SAN LUIS OBISPO,2019,97,93,27,120
6079,SAN LUIS OBISPO,2019,98,44,19,63
6079,SAN LUIS OBISPO,2019,99,26,12,38
6079,SAN LUIS OBISPO,2019,100,30,13,43
6081,SAN MATEO,2017,0,4247,4786,9033
6081,SAN MATEO,2017,1,4295,4635,8930
6081,SAN MATEO,2017,2,4275,4621,8896
6081,SAN MATEO,2017,3,4077,4417,8494
6081,SAN MATEO,2017,4,4263,4365,8628
6081,SAN MATEO,2017,5,4205,4404,8609
6081,SAN MATEO,2017,6,4512,4629,9141
6081,SAN MATEO,2017,7,4630,4800,9430
6081,SAN MATEO,2017,8,4625,4886,9511
6081,SAN MATEO,2017,9,4768,4996,9764
6081,SAN MATEO,2017,10,4651,4897,9548
6081,SAN MATEO,2017,11,4741,4805,9546
6081,SAN MATEO,2017,12,4646,4880,9526
6081,SAN MATEO,2017,13,4509,4639,9148
6081,SAN MATEO,2017,14,4408,4508,8916
6081,SAN MATEO,2017,15,4284,4449,8733
6081,SAN MATEO,2017,16,4186,4266,8452
6081,SAN MATEO,2017,17,3912,4347,8259
6081,SAN MATEO,2017,18,3777,4050,7827
6081,SAN MATEO,2017,19,3679,3843,7522
6081,SAN MATEO,2017,20,3664,3740,7404
6081,SAN MATEO,2017,21,3721,3929,7650
6081,SAN MATEO,2017,22,3795,3988,7783
6081,SAN MATEO,2017,23,4168,4214,8382
6081,SAN MATEO,2017,24,4398,4643,9041
6081,SAN MATEO,2017,25,4212,4613,8825
6081,SAN MATEO,2017,26,3981,4426,8407
6081,SAN MATEO,2017,27,4223,4829,9052
6081,SAN MATEO,2017,28,4288,4755,9043
6081,SAN MATEO,2017,29,4678,5231,9909
6081,SAN MATEO,2017,30,4994,5408,10402
6081,SAN MATEO,2017,31,5099,5453,10552
6081,SAN MATEO,2017,32,5174,5413,10587
6081,SAN MATEO,2017,33,5299,5485,10784
6081,SAN MATEO,2017,34,5337,5393,10730
6081,SAN MATEO,2017,35,5296,5533,10829
6081,SAN MATEO,2017,36,5397,5364,10761
6081,SAN MATEO,2017,37,5444,5602,11046
6081,SAN MATEO,2017,38,5370,5425,10795
6081,SAN MATEO,2017,39,5292,5370,10662
6081,SAN MATEO,2017,40,5409,5542,10951
6081,SAN MATEO,2017,41,5344,5420,10764
6081,SAN MATEO,2017,42,5684,5708,11392
6081,SAN MATEO,2017,43,5655,5677,11332
6081,SAN MATEO,2017,44,5681,5642,11323
6081,SAN MATEO,2017,45,5853,5837,11690
6081,SAN MATEO,2017,46,5937,6245,12182
6081,SAN MATEO,2017,47,6539,6249,12788
6081,SAN MATEO,2017,48,6183,5790,11973
6081,SAN MATEO,2017,49,5707,5640,11347
6081,SAN MATEO,2017,50,5773,5610,11383
6081,SAN MATEO,2017,51,5686,5526,11212
6081,SAN MATEO,2017,52,5528,5834,11362
6081,SAN MATEO,2017,53,5909,5619,11528
6081,SAN MATEO,2017,54,5776,5456,11232
6081,SAN MATEO,2017,55,5708,5335,11043
6081,SAN MATEO,2017,56,5695,5305,11000
6081,SAN MATEO,2017,57,5569,5381,10950
6081,SAN MATEO,2017,58,5365,5198,10563
6081,SAN MATEO,2017,59,5399,5065,10464
6081,SAN MATEO,2017,60,5349,5094,10443
6081,SAN MATEO,2017,61,5261,4777,10038
6081,SAN MATEO,2017,62,5305,4967,10272
6081,SAN MATEO,2017,63,4999,4616,9615
6081,SAN MATEO,2017,64,4808,4357,9165
6081,SAN MATEO,2017,65,4563,4185,8748
6081,SAN MATEO,2017,66,4538,4037,8575
6081,SAN MATEO,2017,67,4506,4121,8627
6081,SAN MATEO,2017,68,4386,3762,8148
6081,SAN MATEO,2017,69,4196,3689,7885
6081,SAN MATEO,2017,70,4132,3571,7703
6081,SAN MATEO,2017,71,3441,2933,6374
6081,SAN MATEO,2017,72,3156,2610,5766
6081,SAN MATEO,2017,73,3109,2476,5585
6081,SAN MATEO,2017,74,3018,2386,5404
6081,SAN MATEO,2017,75,2718,2203,4921
6081,SAN MATEO,2017,76,2518,2084,4602
6081,SAN MATEO,2017,77,2467,1890,4357
6081,SAN MATEO,2017,78,2399,1761,4160
6081,SAN MATEO,2017,79,2121,1703,3824
6081,SAN MATEO,2017,80,2072,1555,3627
6081,SAN MATEO,2017,81,1853,1409,3262
6081,SAN MATEO,2017,82,1677,1263,2940
6081,SAN MATEO,2017,83,1619,1057,2676
6081,SAN MATEO,2017,84,1526,1084,2610
6081,SAN MATEO,2017,85,1582,1009,2591
6081,SAN MATEO,2017,86,1543,1027,2570
6081,SAN MATEO,2017,87,1369,866,2235
6081,SAN MATEO,2017,88,1203,776,1979
6081,SAN MATEO,2017,89,1169,632,1801
6081,SAN MATEO,2017,90,1131,587,1718
6081,SAN MATEO,2017,91,912,453,1365
6081,SAN MATEO,2017,92,711,373,1084
6081,SAN MATEO,2017,93,594,230,824
6081,SAN MATEO,2017,94,424,231,655
6081,SAN MATEO,2017,95,440,187,627
6081,SAN MATEO,2017,96,311,110,421
6081,SAN MATEO,2017,97,231,72,303
6081,SAN MATEO,2017,98,108,44,152
6081,SAN MATEO,2017,99,106,16,122
6081,SAN MATEO,2017,100,133,31,164
6081,SAN MATEO,2018,0,4150,4791,8941
6081,SAN MATEO,2018,1,4225,4764,8989
6081,SAN MATEO,2018,2,4338,4651,8989
6081,SAN MATEO,2018,3,4282,4650,8932
6081,SAN MATEO,2018,4,4101,4438,8539
6081,SAN MATEO,2018,5,4277,4386,8663
6081,SAN MATEO,2018,6,4218,4434,8652
6081,SAN MATEO,2018,7,4533,4639,9172
6081,SAN MATEO,2018,8,4645,4820,9465
6081,SAN MATEO,2018,9,4638,4889,9527
6081,SAN MATEO,2018,10,4776,5012,9788
6081,SAN MATEO,2018,11,4638,4861,9499
6081,SAN MATEO,2018,12,4733,4786,9519
6081,SAN MATEO,2018,13,4606,4853,9459
6081,SAN MATEO,2018,14,4493,4622,9115
6081,SAN MATEO,2018,15,4424,4529,8953
6081,SAN MATEO,2018,16,4181,4335,8516
6081,SAN MATEO,2018,17,4081,4196,8277
6081,SAN MATEO,2018,18,3834,4275,8109
6081,SAN MATEO,2018,19,3659,3930,7589
6081,SAN MATEO,2018,20,3567,3742,7309
6081,SAN MATEO,2018,21,3764,3803,7567
6081,SAN MATEO,2018,22,3788,4020,7808
6081,SAN MATEO,2018,23,3924,4112,8036
6081,SAN MATEO,2018,24,4347,4394,8741
6081,SAN MATEO,2018,25,4515,4758,9273
6081,SAN MATEO,2018,26,4318,4703,9021
6081,SAN MATEO,2018,27,4076,4537,8613
6081,SAN MATEO,2018,28,4323,4927,9250
6081,SAN MATEO,2018,29,4361,4861,9222
6081,SAN MATEO,2018,30,4800,5302,10102
6081,SAN MATEO,2018,31,5013,5415,10428
6081,SAN MATEO,2018,32,5141,5480,10621
6081,SAN MATEO,2018,33,5200,5441,10641
6081,SAN MATEO,2018,34,5312,5502,10814
6081,SAN MATEO,2018,35,5354,5419,10773
6081,SAN MATEO,2018,36,5354,5595,10949
6081,SAN MATEO,2018,37,5443,5406,10849
6081,SAN MATEO,2018,38,5508,5634,11142
6081,SAN MATEO,2018,39,5411,5480,10891
6081,SAN MATEO,2018,40,5349,5451,10800
6081,SAN MATEO,2018,41,5488,5660,11148
6081,SAN MATEO,2018,42,5402,5421,10823
6081,SAN MATEO,2018,43,5722,5773,11495
6081,SAN MATEO,2018,44,5717,5743,11460
6081,SAN MATEO,2018,45,5740,5737,11477
6081,SAN MATEO,2018,46,5889,5841,11730
6081,SAN MATEO,2018,47,5945,6253,12198
6081,SAN MATEO,2018,48,6558,6260,12818
6081,SAN MATEO,2018,49,6193,5807,12000
6081,SAN MATEO,2018,50,5734,5673,11407
6081,SAN MATEO,2018,51,5716,5564,11280
6081,SAN MATEO,2018,52,5663,5510,11173
6081,SAN MATEO,2018,53,5515,5774,11289
6081,SAN MATEO,2018,54,5884,5586,11470
6081,SAN MATEO,2018,55,5746,5417,11163
6081,SAN MATEO,2018,56,5664,5288,10952
6081,SAN MATEO,2018,57,5683,5280,10963
6081,SAN MATEO,2018,58,5539,5333,10872
6081,SAN MATEO,2018,59,5338,5177,10515
6081,SAN MATEO,2018,60,5391,5069,10460
6081,SAN MATEO,2018,61,5325,5037,10362
6081,SAN MATEO,2018,62,5237,4745,9982
6081,SAN MATEO,2018,63,5279,4933,10212
6081,SAN MATEO,2018,64,4979,4557,9536
6081,SAN MATEO,2018,65,4785,4320,9105
6081,SAN MATEO,2018,66,4507,4118,8625
6081,SAN MATEO,2018,67,4472,3961,8433
6081,SAN MATEO,2018,68,4467,4076,8543
6081,SAN MATEO,2018,69,4327,3690,8017
6081,SAN MATEO,2018,70,4158,3619,7777
6081,SAN MATEO,2018,71,4091,3522,7613
6081,SAN MATEO,2018,72,3413,2885,6298
6081,SAN MATEO,2018,73,3126,2562,5688
6081,SAN MATEO,2018,74,3077,2440,5517
6081,SAN MATEO,2018,75,3004,2379,5383
6081,SAN MATEO,2018,76,2667,2118,4785
6081,SAN MATEO,2018,77,2446,2006,4452
6081,SAN MATEO,2018,78,2410,1835,4245
6081,SAN MATEO,2018,79,2380,1719,4099
6081,SAN MATEO,2018,80,2122,1669,3791
6081,SAN MATEO,2018,81,1981,1482,3463
6081,SAN MATEO,2018,82,1786,1326,3112
6081,SAN MATEO,2018,83,1601,1164,2765
6081,SAN MATEO,2018,84,1536,1002,2538
6081,SAN MATEO,2018,85,1614,1064,2678
6081,SAN MATEO,2018,86,1433,936,2369
6081,SAN MATEO,2018,87,1471,944,2415
6081,SAN MATEO,2018,88,1270,763,2033
6081,SAN MATEO,2018,89,1117,717,1834
6081,SAN MATEO,2018,90,1084,560,1644
6081,SAN MATEO,2018,91,976,470,1446
6081,SAN MATEO,2018,92,793,365,1158
6081,SAN MATEO,2018,93,591,300,891
6081,SAN MATEO,2018,94,514,196,710
6081,SAN MATEO,2018,95,368,186,554
6081,SAN MATEO,2018,96,346,123,469
6081,SAN MATEO,2018,97,235,84,319
6081,SAN MATEO,2018,98,177,43,220
6081,SAN MATEO,2018,99,79,28,107
6081,SAN MATEO,2018,100,167,29,196
6081,SAN MATEO,2019,0,4093,4666,8759
6081,SAN MATEO,2019,1,4122,4768,8890
6081,SAN MATEO,2019,2,4265,4784,9049
6081,SAN MATEO,2019,3,4344,4673,9017
6081,SAN MATEO,2019,4,4305,4666,8971
6081,SAN MATEO,2019,5,4120,4468,8588
6081,SAN MATEO,2019,6,4290,4419,8709
6081,SAN MATEO,2019,7,4232,4444,8676
6081,SAN MATEO,2019,8,4551,4656,9207
6081,SAN MATEO,2019,9,4651,4829,9480
6081,SAN MATEO,2019,10,4648,4905,9553
6081,SAN MATEO,2019,11,4765,4988,9753
6081,SAN MATEO,2019,12,4632,4843,9475
6081,SAN MATEO,2019,13,4688,4759,9447
6081,SAN MATEO,2019,14,4581,4830,9411
6081,SAN MATEO,2019,15,4507,4650,9157
6081,SAN MATEO,2019,16,4292,4403,8695
6081,SAN MATEO,2019,17,4090,4292,8382
6081,SAN MATEO,2019,18,3998,4127,8125
6081,SAN MATEO,2019,19,3724,4148,7872
6081,SAN MATEO,2019,20,3535,3841,7376
6081,SAN MATEO,2019,21,3654,3788,7442
6081,SAN MATEO,2019,22,3848,3883,7731
6081,SAN MATEO,2019,23,3930,4166,8096
6081,SAN MATEO,2019,24,4091,4297,8388
6081,SAN MATEO,2019,25,4471,4505,8976
6081,SAN MATEO,2019,26,4627,4864,9491
6081,SAN MATEO,2019,27,4421,4803,9224
6081,SAN MATEO,2019,28,4169,4621,8790
6081,SAN MATEO,2019,29,4408,5037,9445
6081,SAN MATEO,2019,30,4487,4912,9399
6081,SAN MATEO,2019,31,4826,5318,10144
6081,SAN MATEO,2019,32,5053,5449,10502
6081,SAN MATEO,2019,33,5178,5500,10678
6081,SAN MATEO,2019,34,5209,5467,10676
6081,SAN MATEO,2019,35,5331,5510,10841
6081,SAN MATEO,2019,36,5414,5490,10904
6081,SAN MATEO,2019,37,5399,5645,11044
6081,SAN MATEO,2019,38,5495,5437,10932
6081,SAN MATEO,2019,39,5538,5680,11218
6081,SAN MATEO,2019,40,5478,5553,11031
6081,SAN MATEO,2019,41,5437,5536,10973
6081,SAN MATEO,2019,42,5547,5652,11199
6081,SAN MATEO,2019,43,5423,5497,10920
6081,SAN MATEO,2019,44,5804,5847,11651
6081,SAN MATEO,2019,45,5784,5835,11619
6081,SAN MATEO,2019,46,5759,5734,11493
6081,SAN MATEO,2019,47,5909,5863,11772
6081,SAN MATEO,2019,48,5954,6266,12220
6081,SAN MATEO,2019,49,6576,6284,12860
6081,SAN MATEO,2019,50,6219,5837,12056
6081,SAN MATEO,2019,51,5693,5639,11332
6081,SAN MATEO,2019,52,5698,5545,11243
6081,SAN MATEO,2019,53,5645,5441,11086
6081,SAN MATEO,2019,54,5482,5725,11207
6081,SAN MATEO,2019,55,5865,5548,11413
6081,SAN MATEO,2019,56,5709,5381,11090
6081,SAN MATEO,2019,57,5651,5269,10920
6081,SAN MATEO,2019,58,5657,5233,10890
6081,SAN MATEO,2019,59,5512,5307,10819
6081,SAN MATEO,2019,60,5319,5176,10495
6081,SAN MATEO,2019,61,5354,5011,10365
6081,SAN MATEO,2019,62,5300,4997,10297
6081,SAN MATEO,2019,63,5199,4717,9916
6081,SAN MATEO,2019,64,5264,4871,10135
6081,SAN MATEO,2019,65,4954,4509,9463
6081,SAN MATEO,2019,66,4735,4248,8983
6081,SAN MATEO,2019,67,4436,4037,8473
6081,SAN MATEO,2019,68,4434,3911,8345
6081,SAN MATEO,2019,69,4393,4006,8399
6081,SAN MATEO,2019,70,4294,3643,7937
6081,SAN MATEO,2019,71,4118,3568,7686
6081,SAN MATEO,2019,72,4043,3470,7513
6081,SAN MATEO,2019,73,3395,2838,6233
6081,SAN MATEO,2019,74,3094,2529,5623
6081,SAN MATEO,2019,75,3073,2430,5503
6081,SAN MATEO,2019,76,2949,2297,5246
6081,SAN MATEO,2019,77,2600,2045,4645
6081,SAN MATEO,2019,78,2385,1937,4322
6081,SAN MATEO,2019,79,2387,1785,4172
6081,SAN MATEO,2019,80,2359,1675,4034
6081,SAN MATEO,2019,81,2026,1599,3625
6081,SAN MATEO,2019,82,1922,1396,3318
6081,SAN MATEO,2019,83,1717,1231,2948
6081,SAN MATEO,2019,84,1531,1115,2646
6081,SAN MATEO,2019,85,1630,990,2620
6081,SAN MATEO,2019,86,1472,974,2446
6081,SAN MATEO,2019,87,1364,856,2220
6081,SAN MATEO,2019,88,1366,852,2218
6081,SAN MATEO,2019,89,1174,711,1885
6081,SAN MATEO,2019,90,1022,636,1658
6081,SAN MATEO,2019,91,918,456,1374
6081,SAN MATEO,2019,92,835,383,1218
6081,SAN MATEO,2019,93,673,304,977
6081,SAN MATEO,2019,94,499,244,743
6081,SAN MATEO,2019,95,435,152,587
6081,SAN MATEO,2019,96,271,119,390
6081,SAN MATEO,2019,97,272,89,361
6081,SAN MATEO,2019,98,175,56,231
6081,SAN MATEO,2019,99,122,29,151
6081,SAN MATEO,2019,100,169,44,213
6083,SANTA BARBARA,2017,0,2541,2771,5312
6083,SANTA BARBARA,2017,1,2785,2777,5562
6083,SANTA BARBARA,2017,2,2795,3050,5845
6083,SANTA BARBARA,2017,3,2811,3023,5834
6083,SANTA BARBARA,2017,4,2817,2994,5811
6083,SANTA BARBARA,2017,5,2810,2988,5798
6083,SANTA BARBARA,2017,6,2822,3024,5846
6083,SANTA BARBARA,2017,7,2750,2840,5590
6083,SANTA BARBARA,2017,8,2699,2820,5519
6083,SANTA BARBARA,2017,9,2696,2854,5550
6083,SANTA BARBARA,2017,10,2712,2819,5531
6083,SANTA BARBARA,2017,11,2765,2841,5606
6083,SANTA BARBARA,2017,12,2690,2846,5536
6083,SANTA BARBARA,2017,13,2692,2646,5338
6083,SANTA BARBARA,2017,14,2551,2742,5293
6083,SANTA BARBARA,2017,15,2617,2736,5353
6083,SANTA BARBARA,2017,16,2676,2840,5516
6083,SANTA BARBARA,2017,17,2813,3049,5862
6083,SANTA BARBARA,2017,18,5117,4999,10116
6083,SANTA BARBARA,2017,19,5798,5969,11767
6083,SANTA BARBARA,2017,20,5557,5999,11556
6083,SANTA BARBARA,2017,21,5485,5911,11396
6083,SANTA BARBARA,2017,22,3517,3800,7317
6083,SANTA BARBARA,2017,23,3232,3579,6811
6083,SANTA BARBARA,2017,24,3407,3591,6998
6083,SANTA BARBARA,2017,25,3224,3585,6809
6083,SANTA BARBARA,2017,26,2884,3090,5974
6083,SANTA BARBARA,2017,27,2603,2927,5530
6083,SANTA BARBARA,2017,28,2483,2800,5283
6083,SANTA BARBARA,2017,29,2926,3417,6343
6083,SANTA BARBARA,2017,30,2719,3443,6162
6083,SANTA BARBARA,2017,31,2506,3308,5814
6083,SANTA BARBARA,2017,32,2668,3234,5902
6083,SANTA BARBARA,2017,33,2917,3240,6157
6083,SANTA BARBARA,2017,34,2822,3345,6167
6083,SANTA BARBARA,2017,35,2839,3205,6044
6083,SANTA BARBARA,2017,36,2648,3038,5686
6083,SANTA BARBARA,2017,37,2674,3067,5741
6083,SANTA BARBARA,2017,38,2572,2950,5522
6083,SANTA BARBARA,2017,39,2633,2907,5540
6083,SANTA BARBARA,2017,40,2585,2736,5321
6083,SANTA BARBARA,2017,41,2455,2701,5156
6083,SANTA BARBARA,2017,42,2452,2815,5267
6083,SANTA BARBARA,2017,43,2414,2704,5118
6083,SANTA BARBARA,2017,44,2429,2549,4978
6083,SANTA BARBARA,2017,45,2377,2556,4933
6083,SANTA BARBARA,2017,46,2480,2683,5163
6083,SANTA BARBARA,2017,47,2569,2721,5290
6083,SANTA BARBARA,2017,48,2408,2483,4891
6083,SANTA BARBARA,2017,49,2396,2542,4938
6083,SANTA BARBARA,2017,50,2424,2318,4742
6083,SANTA BARBARA,2017,51,2418,2429,4847
6083,SANTA BARBARA,2017,52,2638,2572,5210
6083,SANTA BARBARA,2017,53,2739,2672,5411
6083,SANTA BARBARA,2017,54,2779,2645,5424
6083,SANTA BARBARA,2017,55,2809,2719,5528
6083,SANTA BARBARA,2017,56,2924,2845,5769
6083,SANTA BARBARA,2017,57,3031,2769,5800
6083,SANTA BARBARA,2017,58,2756,2796,5552
6083,SANTA BARBARA,2017,59,2767,2682,5449
6083,SANTA BARBARA,2017,60,2667,2462,5129
6083,SANTA BARBARA,2017,61,2672,2526,5198
6083,SANTA BARBARA,2017,62,2572,2477,5049
6083,SANTA BARBARA,2017,63,2420,2344,4764
6083,SANTA BARBARA,2017,64,2503,2259,4762
6083,SANTA BARBARA,2017,65,2389,2092,4481
6083,SANTA BARBARA,2017,66,2234,2047,4281
6083,SANTA BARBARA,2017,67,2201,2047,4248
6083,SANTA BARBARA,2017,68,2139,1851,3990
6083,SANTA BARBARA,2017,69,2072,1873,3945
6083,SANTA BARBARA,2017,70,1978,1915,3893
6083,SANTA BARBARA,2017,71,1623,1544,3167
6083,SANTA BARBARA,2017,72,1637,1396,3033
6083,SANTA BARBARA,2017,73,1620,1317,2937
6083,SANTA BARBARA,2017,74,1447,1291,2738
6083,SANTA BARBARA,2017,75,1387,1143,2530
6083,SANTA BARBARA,2017,76,1251,1021,2272
6083,SANTA BARBARA,2017,77,1196,1029,2225
6083,SANTA BARBARA,2017,78,1168,902,2070
6083,SANTA BARBARA,2017,79,1117,900,2017
6083,SANTA BARBARA,2017,80,1078,792,1870
6083,SANTA BARBARA,2017,81,1011,718,1729
6083,SANTA BARBARA,2017,82,1002,710,1712
6083,SANTA BARBARA,2017,83,882,672,1554
6083,SANTA BARBARA,2017,84,842,620,1462
6083,SANTA BARBARA,2017,85,938,659,1597
6083,SANTA BARBARA,2017,86,846,580,1426
6083,SANTA BARBARA,2017,87,814,485,1299
6083,SANTA BARBARA,2017,88,658,403,1061
6083,SANTA BARBARA,2017,89,643,394,1037
6083,SANTA BARBARA,2017,90,621,341,962
6083,SANTA BARBARA,2017,91,579,231,810
6083,SANTA BARBARA,2017,92,385,196,581
6083,SANTA BARBARA,2017,93,322,147,469
6083,SANTA BARBARA,2017,94,307,92,399
6083,SANTA BARBARA,2017,95,236,103,339
6083,SANTA BARBARA,2017,96,135,66,201
6083,SANTA BARBARA,2017,97,118,47,165
6083,SANTA BARBARA,2017,98,63,21,84
6083,SANTA BARBARA,2017,99,20,14,34
6083,SANTA BARBARA,2017,100,33,11,44
6083,SANTA BARBARA,2018,0,2577,2899,5476
6083,SANTA BARBARA,2018,1,2540,2756,5296
6083,SANTA BARBARA,2018,2,2811,2795,5606
6083,SANTA BARBARA,2018,3,2808,3064,5872
6083,SANTA BARBARA,2018,4,2825,3040,5865
6083,SANTA BARBARA,2018,5,2829,3009,5838
6083,SANTA BARBARA,2018,6,2793,2975,5768
6083,SANTA BARBARA,2018,7,2819,3013,5832
6083,SANTA BARBARA,2018,8,2726,2833,5559
6083,SANTA BARBARA,2018,9,2687,2817,5504
6083,SANTA BARBARA,2018,10,2692,2849,5541
6083,SANTA BARBARA,2018,11,2729,2835,5564
6083,SANTA BARBARA,2018,12,2780,2869,5649
6083,SANTA BARBARA,2018,13,2702,2878,5580
6083,SANTA BARBARA,2018,14,2703,2666,5369
6083,SANTA BARBARA,2018,15,2629,2838,5467
6083,SANTA BARBARA,2018,16,2630,2729,5359
6083,SANTA BARBARA,2018,17,2752,2935,5687
6083,SANTA BARBARA,2018,18,5093,5066,10159
6083,SANTA BARBARA,2018,19,5914,6017,11931
6083,SANTA BARBARA,2018,20,5517,5970,11487
6083,SANTA BARBARA,2018,21,5454,5861,11315
6083,SANTA BARBARA,2018,22,3778,4086,7864
6083,SANTA BARBARA,2018,23,3091,3407,6498
6083,SANTA BARBARA,2018,24,3085,3428,6513
6083,SANTA BARBARA,2018,25,3279,3482,6761
6083,SANTA BARBARA,2018,26,3024,3424,6448
6083,SANTA BARBARA,2018,27,2888,3111,5999
6083,SANTA BARBARA,2018,28,2624,2881,5505
6083,SANTA BARBARA,2018,29,2541,2880,5421
6083,SANTA BARBARA,2018,30,2831,3352,6183
6083,SANTA BARBARA,2018,31,2646,3361,6007
6083,SANTA BARBARA,2018,32,2502,3316,5818
6083,SANTA BARBARA,2018,33,2693,3241,5934
6083,SANTA BARBARA,2018,34,2973,3264,6237
6083,SANTA BARBARA,2018,35,2793,3348,6141
6083,SANTA BARBARA,2018,36,2794,3141,5935
6083,SANTA BARBARA,2018,37,2665,3071,5736
6083,SANTA BARBARA,2018,38,2718,3111,5829
6083,SANTA BARBARA,2018,39,2600,2953,5553
6083,SANTA BARBARA,2018,40,2650,2909,5559
6083,SANTA BARBARA,2018,41,2579,2728,5307
6083,SANTA BARBARA,2018,42,2446,2685,5131
6083,SANTA BARBARA,2018,43,2447,2797,5244
6083,SANTA BARBARA,2018,44,2417,2744,5161
6083,SANTA BARBARA,2018,45,2418,2514,4932
6083,SANTA BARBARA,2018,46,2377,2556,4933
6083,SANTA BARBARA,2018,47,2481,2658,5139
6083,SANTA BARBARA,2018,48,2573,2684,5257
6083,SANTA BARBARA,2018,49,2394,2478,4872
6083,SANTA BARBARA,2018,50,2398,2505,4903
6083,SANTA BARBARA,2018,51,2439,2345,4784
6083,SANTA BARBARA,2018,52,2425,2416,4841
6083,SANTA BARBARA,2018,53,2659,2594,5253
6083,SANTA BARBARA,2018,54,2740,2663,5403
6083,SANTA BARBARA,2018,55,2786,2654,5440
6083,SANTA BARBARA,2018,56,2803,2667,5470
6083,SANTA BARBARA,2018,57,2899,2835,5734
6083,SANTA BARBARA,2018,58,3027,2748,5775
6083,SANTA BARBARA,2018,59,2740,2779,5519
6083,SANTA BARBARA,2018,60,2763,2650,5413
6083,SANTA BARBARA,2018,61,2650,2454,5104
6083,SANTA BARBARA,2018,62,2667,2483,5150
6083,SANTA BARBARA,2018,63,2562,2463,5025
6083,SANTA BARBARA,2018,64,2403,2319,4722
6083,SANTA BARBARA,2018,65,2488,2237,4725
6083,SANTA BARBARA,2018,66,2363,2062,4425
6083,SANTA BARBARA,2018,67,2213,2007,4220
6083,SANTA BARBARA,2018,68,2192,2023,4215
6083,SANTA BARBARA,2018,69,2115,1821,3936
6083,SANTA BARBARA,2018,70,2053,1846,3899
6083,SANTA BARBARA,2018,71,1944,1888,3832
6083,SANTA BARBARA,2018,72,1621,1494,3115
6083,SANTA BARBARA,2018,73,1611,1382,2993
6083,SANTA BARBARA,2018,74,1599,1282,2881
6083,SANTA BARBARA,2018,75,1444,1271,2715
6083,SANTA BARBARA,2018,76,1339,1115,2454
6083,SANTA BARBARA,2018,77,1234,972,2206
6083,SANTA BARBARA,2018,78,1177,1001,2178
6083,SANTA BARBARA,2018,79,1142,878,2020
6083,SANTA BARBARA,2018,80,1110,873,1983
6083,SANTA BARBARA,2018,81,1029,747,1776
6083,SANTA BARBARA,2018,82,964,683,1647
6083,SANTA BARBARA,2018,83,947,667,1614
6083,SANTA BARBARA,2018,84,861,650,1511
6083,SANTA BARBARA,2018,85,861,592,1453
6083,SANTA BARBARA,2018,86,874,588,1462
6083,SANTA BARBARA,2018,87,792,546,1338
6083,SANTA BARBARA,2018,88,735,445,1180
6083,SANTA BARBARA,2018,89,622,383,1005
6083,SANTA BARBARA,2018,90,579,347,926
6083,SANTA BARBARA,2018,91,525,276,801
6083,SANTA BARBARA,2018,92,504,184,688
6083,SANTA BARBARA,2018,93,326,156,482
6083,SANTA BARBARA,2018,94,274,119,393
6083,SANTA BARBARA,2018,95,256,72,328
6083,SANTA BARBARA,2018,96,176,68,244
6083,SANTA BARBARA,2018,97,103,46,149
6083,SANTA BARBARA,2018,98,87,34,121
6083,SANTA BARBARA,2018,99,52,17,69
6083,SANTA BARBARA,2018,100,31,13,44
6083,SANTA BARBARA,2019,0,2610,2834,5444
6083,SANTA BARBARA,2019,1,2570,2877,5447
6083,SANTA BARBARA,2019,2,2563,2773,5336
6083,SANTA BARBARA,2019,3,2818,2816,5634
6083,SANTA BARBARA,2019,4,2824,3078,5902
6083,SANTA BARBARA,2019,5,2838,3058,5896
6083,SANTA BARBARA,2019,6,2812,2995,5807
6083,SANTA BARBARA,2019,7,2791,2967,5758
6083,SANTA BARBARA,2019,8,2803,3001,5804
6083,SANTA BARBARA,2019,9,2719,2820,5539
6083,SANTA BARBARA,2019,10,2680,2812,5492
6083,SANTA BARBARA,2019,11,2708,2869,5577
6083,SANTA BARBARA,2019,12,2743,2858,5601
6083,SANTA BARBARA,2019,13,2798,2896,5694
6083,SANTA BARBARA,2019,14,2714,2896,5610
6083,SANTA BARBARA,2019,15,2790,2755,5545
6083,SANTA BARBARA,2019,16,2641,2829,5470
6083,SANTA BARBARA,2019,17,2702,2831,5533
6083,SANTA BARBARA,2019,18,5018,4952,9970
6083,SANTA BARBARA,2019,19,5890,6082,11972
6083,SANTA BARBARA,2019,20,5644,6025,11669
6083,SANTA BARBARA,2019,21,5413,5833,11246
6083,SANTA BARBARA,2019,22,3752,4035,7787
6083,SANTA BARBARA,2019,23,3346,3695,7041
6083,SANTA BARBARA,2019,24,2942,3253,6195
6083,SANTA BARBARA,2019,25,2956,3321,6277
6083,SANTA BARBARA,2019,26,3080,3316,6396
6083,SANTA BARBARA,2019,27,3033,3439,6472
6083,SANTA BARBARA,2019,28,2908,3066,5974
6083,SANTA BARBARA,2019,29,2682,2954,5636
6083,SANTA BARBARA,2019,30,2448,2814,5262
6083,SANTA BARBARA,2019,31,2757,3285,6042
6083,SANTA BARBARA,2019,32,2639,3367,6006
6083,SANTA BARBARA,2019,33,2533,3322,5855
6083,SANTA BARBARA,2019,34,2744,3266,6010
6083,SANTA BARBARA,2019,35,2945,3257,6202
6083,SANTA BARBARA,2019,36,2742,3291,6033
6083,SANTA BARBARA,2019,37,2817,3166,5983
6083,SANTA BARBARA,2019,38,2713,3101,5814
6083,SANTA BARBARA,2019,39,2746,3118,5864
6083,SANTA BARBARA,2019,40,2614,2969,5583
6083,SANTA BARBARA,2019,41,2646,2904,5550
6083,SANTA BARBARA,2019,42,2569,2708,5277
6083,SANTA BARBARA,2019,43,2438,2667,5105
6083,SANTA BARBARA,2019,44,2447,2840,5287
6083,SANTA BARBARA,2019,45,2403,2708,5111
6083,SANTA BARBARA,2019,46,2417,2514,4931
6083,SANTA BARBARA,2019,47,2373,2528,4901
6083,SANTA BARBARA,2019,48,2487,2629,5116
6083,SANTA BARBARA,2019,49,2563,2674,5237
6083,SANTA BARBARA,2019,50,2397,2437,4834
6083,SANTA BARBARA,2019,51,2422,2525,4947
6083,SANTA BARBARA,2019,52,2453,2324,4777
6083,SANTA BARBARA,2019,53,2440,2440,4880
6083,SANTA BARBARA,2019,54,2667,2585,5252
6083,SANTA BARBARA,2019,55,2746,2682,5428
6083,SANTA BARBARA,2019,56,2782,2612,5394
6083,SANTA BARBARA,2019,57,2771,2657,5428
6083,SANTA BARBARA,2019,58,2899,2816,5715
6083,SANTA BARBARA,2019,59,3016,2728,5744
6083,SANTA BARBARA,2019,60,2733,2756,5489
6083,SANTA BARBARA,2019,61,2737,2650,5387
6083,SANTA BARBARA,2019,62,2650,2417,5067
6083,SANTA BARBARA,2019,63,2666,2457,5123
6083,SANTA BARBARA,2019,64,2539,2433,4972
6083,SANTA BARBARA,2019,65,2393,2300,4693
6083,SANTA BARBARA,2019,66,2460,2212,4672
6083,SANTA BARBARA,2019,67,2343,2025,4368
6083,SANTA BARBARA,2019,68,2199,1993,4192
6083,SANTA BARBARA,2019,69,2168,1987,4155
6083,SANTA BARBARA,2019,70,2106,1800,3906
6083,SANTA BARBARA,2019,71,2019,1824,3843
6083,SANTA BARBARA,2019,72,1934,1827,3761
6083,SANTA BARBARA,2019,73,1591,1479,3070
6083,SANTA BARBARA,2019,74,1595,1348,2943
6083,SANTA BARBARA,2019,75,1592,1275,2867
6083,SANTA BARBARA,2019,76,1397,1229,2626
6083,SANTA BARBARA,2019,77,1320,1066,2386
6083,SANTA BARBARA,2019,78,1205,947,2152
6083,SANTA BARBARA,2019,79,1146,964,2110
6083,SANTA BARBARA,2019,80,1146,845,1991
6083,SANTA BARBARA,2019,81,1052,832,1884
6083,SANTA BARBARA,2019,82,1003,714,1717
6083,SANTA BARBARA,2019,83,901,643,1544
6083,SANTA BARBARA,2019,84,933,635,1568
6083,SANTA BARBARA,2019,85,864,630,1494
6083,SANTA BARBARA,2019,86,794,539,1333
6083,SANTA BARBARA,2019,87,827,553,1380
6083,SANTA BARBARA,2019,88,720,495,1215
6083,SANTA BARBARA,2019,89,697,410,1107
6083,SANTA BARBARA,2019,90,549,336,885
6083,SANTA BARBARA,2019,91,485,283,768
6083,SANTA BARBARA,2019,92,460,206,666
6083,SANTA BARBARA,2019,93,420,146,566
6083,SANTA BARBARA,2019,94,287,123,410
6083,SANTA BARBARA,2019,95,226,90,316
6083,SANTA BARBARA,2019,96,207,43,250
6083,SANTA BARBARA,2019,97,132,48,180
6083,SANTA BARBARA,2019,98,63,34,97
6083,SANTA BARBARA,2019,99,71,25,96
6083,SANTA BARBARA,2019,100,53,16,69
6085,SANTA CLARA,2017,0,10954,12075,23029
6085,SANTA CLARA,2017,1,11274,11817,23091
6085,SANTA CLARA,2017,2,11777,12493,24270
6085,SANTA CLARA,2017,3,11914,12631,24545
6085,SANTA CLARA,2017,4,12278,13177,25455
6085,SANTA CLARA,2017,5,12154,12882,25036
6085,SANTA CLARA,2017,6,12085,13144,25229
6085,SANTA CLARA,2017,7,12149,12728,24877
6085,SANTA CLARA,2017,8,12347,13098,25445
6085,SANTA CLARA,2017,9,12894,13454,26348
6085,SANTA CLARA,2017,10,12931,13540,26471
6085,SANTA CLARA,2017,11,12511,13160,25671
6085,SANTA CLARA,2017,12,12357,12779,25136
6085,SANTA CLARA,2017,13,12033,12730,24763
6085,SANTA CLARA,2017,14,12178,12581,24759
6085,SANTA CLARA,2017,15,11512,12170,23682
6085,SANTA CLARA,2017,16,11611,12276,23887
6085,SANTA CLARA,2017,17,11291,11657,22948
6085,SANTA CLARA,2017,18,12843,13523,26366
6085,SANTA CLARA,2017,19,13047,13817,26864
6085,SANTA CLARA,2017,20,12449,13078,25527
6085,SANTA CLARA,2017,21,12306,13194,25500
6085,SANTA CLARA,2017,22,11806,12860,24666
6085,SANTA CLARA,2017,23,12102,13180,25282
6085,SANTA CLARA,2017,24,12166,13637,25803
6085,SANTA CLARA,2017,25,10985,12399,23384
6085,SANTA CLARA,2017,26,10076,11738,21814
6085,SANTA CLARA,2017,27,10272,12150,22422
6085,SANTA CLARA,2017,28,10547,12377,22924
6085,SANTA CLARA,2017,29,11044,12571,23615
6085,SANTA CLARA,2017,30,11693,13200,24893
6085,SANTA CLARA,2017,31,12010,13884,25894
6085,SANTA CLARA,2017,32,13451,15147,28598
6085,SANTA CLARA,2017,33,14278,15701,29979
6085,SANTA CLARA,2017,34,14676,16006,30682
6085,SANTA CLARA,2017,35,14871,15650,30521
6085,SANTA CLARA,2017,36,14541,15059,29600
6085,SANTA CLARA,2017,37,14470,15357,29827
6085,SANTA CLARA,2017,38,13913,14465,28378
6085,SANTA CLARA,2017,39,13956,14265,28221
6085,SANTA CLARA,2017,40,13533,14257,27790
6085,SANTA CLARA,2017,41,13748,14438,28186
6085,SANTA CLARA,2017,42,13913,14498,28411
6085,SANTA CLARA,2017,43,13742,14140,27882
6085,SANTA CLARA,2017,44,13839,14468,28307
6085,SANTA CLARA,2017,45,14140,14413,28553
6085,SANTA CLARA,2017,46,14302,14721,29023
6085,SANTA CLARA,2017,47,14575,15113,29688
6085,SANTA CLARA,2017,48,14113,14261,28374
6085,SANTA CLARA,2017,49,13546,13852,27398
6085,SANTA CLARA,2017,50,12940,13354,26294
6085,SANTA CLARA,2017,51,13032,13438,26470
6085,SANTA CLARA,2017,52,13414,14124,27538
6085,SANTA CLARA,2017,53,13300,14165,27465
6085,SANTA CLARA,2017,54,13496,13732,27228
6085,SANTA CLARA,2017,55,13013,13520,26533
6085,SANTA CLARA,2017,56,13052,13453,26505
6085,SANTA CLARA,2017,57,13008,13351,26359
6085,SANTA CLARA,2017,58,12417,12384,24801
6085,SANTA CLARA,2017,59,11872,12249,24121
6085,SANTA CLARA,2017,60,11696,11798,23494
6085,SANTA CLARA,2017,61,11528,11278,22806
6085,SANTA CLARA,2017,62,11084,10963,22047
6085,SANTA CLARA,2017,63,10479,10017,20496
6085,SANTA CLARA,2017,64,9985,9440,19425
6085,SANTA CLARA,2017,65,9470,8846,18316
6085,SANTA CLARA,2017,66,9319,8469,17788
6085,SANTA CLARA,2017,67,9286,8408,17694
6085,SANTA CLARA,2017,68,8834,7884,16718
6085,SANTA CLARA,2017,69,8413,7653,16066
6085,SANTA CLARA,2017,70,8619,7375,15994
6085,SANTA CLARA,2017,71,7197,6430,13627
6085,SANTA CLARA,2017,72,6925,6088,13013
6085,SANTA CLARA,2017,73,6614,5635,12249
6085,SANTA CLARA,2017,74,6396,5545,11941
6085,SANTA CLARA,2017,75,5830,4956,10786
6085,SANTA CLARA,2017,76,5573,4396,9969
6085,SANTA CLARA,2017,77,5088,4067,9155
6085,SANTA CLARA,2017,78,4883,3971,8854
6085,SANTA CLARA,2017,79,4682,3607,8289
6085,SANTA CLARA,2017,80,4404,3400,7804
6085,SANTA CLARA,2017,81,3991,3269,7260
6085,SANTA CLARA,2017,82,3892,2894,6786
6085,SANTA CLARA,2017,83,3348,2494,5842
6085,SANTA CLARA,2017,84,3296,2454,5750
6085,SANTA CLARA,2017,85,3292,2334,5626
6085,SANTA CLARA,2017,86,3212,2169,5381
6085,SANTA CLARA,2017,87,2684,1852,4536
6085,SANTA CLARA,2017,88,2434,1485,3919
6085,SANTA CLARA,2017,89,2311,1350,3661
6085,SANTA CLARA,2017,90,2102,1138,3240
6085,SANTA CLARA,2017,91,1821,1000,2821
6085,SANTA CLARA,2017,92,1432,779,2211
6085,SANTA CLARA,2017,93,1023,599,1622
6085,SANTA CLARA,2017,94,907,475,1382
6085,SANTA CLARA,2017,95,792,365,1157
6085,SANTA CLARA,2017,96,530,272,802
6085,SANTA CLARA,2017,97,363,204,567
6085,SANTA CLARA,2017,98,246,80,326
6085,SANTA CLARA,2017,99,171,69,240
6085,SANTA CLARA,2017,100,225,73,298
6085,SANTA CLARA,2018,0,10911,11902,22813
6085,SANTA CLARA,2018,1,10917,12036,22953
6085,SANTA CLARA,2018,2,11382,12066,23448
6085,SANTA CLARA,2018,3,11944,12626,24570
6085,SANTA CLARA,2018,4,12020,12750,24770
6085,SANTA CLARA,2018,5,12393,13310,25703
6085,SANTA CLARA,2018,6,12160,12898,25058
6085,SANTA CLARA,2018,7,12096,13153,25249
6085,SANTA CLARA,2018,8,12154,12738,24892
6085,SANTA CLARA,2018,9,12367,13102,25469
6085,SANTA CLARA,2018,10,12892,13455,26347
6085,SANTA CLARA,2018,11,12941,13562,26503
6085,SANTA CLARA,2018,12,12498,13153,25651
6085,SANTA CLARA,2018,13,12359,12791,25150
6085,SANTA CLARA,2018,14,12038,12739,24777
6085,SANTA CLARA,2018,15,12195,12610,24805
6085,SANTA CLARA,2018,16,11334,11962,23296
6085,SANTA CLARA,2018,17,11591,12268,23859
6085,SANTA CLARA,2018,18,13513,14007,27520
6085,SANTA CLARA,2018,19,13153,13823,26976
6085,SANTA CLARA,2018,20,12396,13302,25698
6085,SANTA CLARA,2018,21,12314,13088,25402
6085,SANTA CLARA,2018,22,12430,13410,25840
6085,SANTA CLARA,2018,23,11861,12982,24843
6085,SANTA CLARA,2018,24,12283,13517,25800
6085,SANTA CLARA,2018,25,11940,13243,25183
6085,SANTA CLARA,2018,26,10510,12085,22595
6085,SANTA CLARA,2018,27,10353,12103,22456
6085,SANTA CLARA,2018,28,10637,12576,23213
6085,SANTA CLARA,2018,29,10846,12670,23516
6085,SANTA CLARA,2018,30,11291,12829,24120
6085,SANTA CLARA,2018,31,11901,13439,25340
6085,SANTA CLARA,2018,32,12214,14110,26324
6085,SANTA CLARA,2018,33,13591,15304,28895
6085,SANTA CLARA,2018,34,14366,15780,30146
6085,SANTA CLARA,2018,35,14811,16230,31041
6085,SANTA CLARA,2018,36,14828,15569,30397
6085,SANTA CLARA,2018,37,14564,15095,29659
6085,SANTA CLARA,2018,38,14505,15409,29914
6085,SANTA CLARA,2018,39,13949,14529,28478
6085,SANTA CLARA,2018,40,13978,14307,28285
6085,SANTA CLARA,2018,41,13555,14249,27804
6085,SANTA CLARA,2018,42,13785,14477,28262
6085,SANTA CLARA,2018,43,13933,14488,28421
6085,SANTA CLARA,2018,44,13755,14178,27933
6085,SANTA CLARA,2018,45,13842,14475,28317
6085,SANTA CLARA,2018,46,14125,14422,28547
6085,SANTA CLARA,2018,47,14299,14690,28989
6085,SANTA CLARA,2018,48,14538,15116,29654
6085,SANTA CLARA,2018,49,14127,14246,28373
6085,SANTA CLARA,2018,50,13541,13806,27347
6085,SANTA CLARA,2018,51,12921,13285,26206
6085,SANTA CLARA,2018,52,12976,13389,26365
6085,SANTA CLARA,2018,53,13377,14028,27405
6085,SANTA CLARA,2018,54,13236,14126,27362
6085,SANTA CLARA,2018,55,13474,13679,27153
6085,SANTA CLARA,2018,56,12960,13433,26393
6085,SANTA CLARA,2018,57,12982,13326,26308
6085,SANTA CLARA,2018,58,12939,13263,26202
6085,SANTA CLARA,2018,59,12380,12340,24720
6085,SANTA CLARA,2018,60,11820,12143,23963
6085,SANTA CLARA,2018,61,11625,11675,23300
6085,SANTA CLARA,2018,62,11471,11193,22664
6085,SANTA CLARA,2018,63,10996,10844,21840
6085,SANTA CLARA,2018,64,10398,9926,20324
6085,SANTA CLARA,2018,65,9925,9336,19261
6085,SANTA CLARA,2018,66,9463,8770,18233
6085,SANTA CLARA,2018,67,9263,8405,17668
6085,SANTA CLARA,2018,68,9238,8335,17573
6085,SANTA CLARA,2018,69,8779,7809,16588
6085,SANTA CLARA,2018,70,8445,7590,16035
6085,SANTA CLARA,2018,71,8554,7253,15807
6085,SANTA CLARA,2018,72,7164,6340,13504
6085,SANTA CLARA,2018,73,6822,5982,12804
6085,SANTA CLARA,2018,74,6558,5549,12107
6085,SANTA CLARA,2018,75,6356,5501,11857
6085,SANTA CLARA,2018,76,5738,4814,10552
6085,SANTA CLARA,2018,77,5503,4295,9798
6085,SANTA CLARA,2018,78,4985,3953,8938
6085,SANTA CLARA,2018,79,4794,3872,8666
6085,SANTA CLARA,2018,80,4651,3556,8207
6085,SANTA CLARA,2018,81,4279,3234,7513
6085,SANTA CLARA,2018,82,3855,3140,6995
6085,SANTA CLARA,2018,83,3736,2736,6472
6085,SANTA CLARA,2018,84,3255,2386,5641
6085,SANTA CLARA,2018,85,3348,2379,5727
6085,SANTA CLARA,2018,86,3099,2168,5267
6085,SANTA CLARA,2018,87,2983,1984,4967
6085,SANTA CLARA,2018,88,2514,1682,4196
6085,SANTA CLARA,2018,89,2293,1353,3646
6085,SANTA CLARA,2018,90,2134,1231,3365
6085,SANTA CLARA,2018,91,1846,964,2810
6085,SANTA CLARA,2018,92,1563,824,2387
6085,SANTA CLARA,2018,93,1220,655,1875
6085,SANTA CLARA,2018,94,884,515,1399
6085,SANTA CLARA,2018,95,754,377,1131
6085,SANTA CLARA,2018,96,607,277,884
6085,SANTA CLARA,2018,97,402,215,617
6085,SANTA CLARA,2018,98,289,141,430
6085,SANTA CLARA,2018,99,194,56,250
6085,SANTA CLARA,2018,100,270,94,364
6085,SANTA CLARA,2019,0,10635,11938,22573
6085,SANTA CLARA,2019,1,10872,11875,22747
6085,SANTA CLARA,2019,2,11036,12245,23281
6085,SANTA CLARA,2019,3,11582,12208,23790
6085,SANTA CLARA,2019,4,12066,12747,24813
6085,SANTA CLARA,2019,5,12112,12910,25022
6085,SANTA CLARA,2019,6,12404,13325,25729
6085,SANTA CLARA,2019,7,12168,12906,25074
6085,SANTA CLARA,2019,8,12094,13165,25259
6085,SANTA CLARA,2019,9,12177,12744,24921
6085,SANTA CLARA,2019,10,12368,13103,25471
6085,SANTA CLARA,2019,11,12903,13476,26379
6085,SANTA CLARA,2019,12,12933,13551,26484
6085,SANTA CLARA,2019,13,12507,13163,25670
6085,SANTA CLARA,2019,14,12358,12798,25156
6085,SANTA CLARA,2019,15,12064,12776,24840
6085,SANTA CLARA,2019,16,12026,12426,24452
6085,SANTA CLARA,2019,17,11333,11945,23278
6085,SANTA CLARA,2019,18,13832,14622,28454
6085,SANTA CLARA,2019,19,13858,14324,28182
6085,SANTA CLARA,2019,20,12494,13328,25822
6085,SANTA CLARA,2019,21,12286,13319,25605
6085,SANTA CLARA,2019,22,12435,13284,25719
6085,SANTA CLARA,2019,23,12479,13519,25998
6085,SANTA CLARA,2019,24,12099,13334,25433
6085,SANTA CLARA,2019,25,12094,13086,25180
6085,SANTA CLARA,2019,26,11466,12958,24424
6085,SANTA CLARA,2019,27,10798,12486,23284
6085,SANTA CLARA,2019,28,10731,12521,23252
6085,SANTA CLARA,2019,29,10914,12884,23798
6085,SANTA CLARA,2019,30,11078,12947,24025
6085,SANTA CLARA,2019,31,11512,13023,24535
6085,SANTA CLARA,2019,32,12123,13686,25809
6085,SANTA CLARA,2019,33,12325,14296,26621
6085,SANTA CLARA,2019,34,13704,15397,29101
6085,SANTA CLARA,2019,35,14509,16001,30510
6085,SANTA CLARA,2019,36,14780,16158,30938
6085,SANTA CLARA,2019,37,14861,15612,30473
6085,SANTA CLARA,2019,38,14602,15133,29735
6085,SANTA CLARA,2019,39,14522,15465,29987
6085,SANTA CLARA,2019,40,13973,14580,28553
6085,SANTA CLARA,2019,41,14015,14298,28313
6085,SANTA CLARA,2019,42,13595,14276,27871
6085,SANTA CLARA,2019,43,13801,14482,28283
6085,SANTA CLARA,2019,44,13944,14533,28477
6085,SANTA CLARA,2019,45,13772,14188,27960
6085,SANTA CLARA,2019,46,13831,14471,28302
6085,SANTA CLARA,2019,47,14118,14391,28509
6085,SANTA CLARA,2019,48,14275,14694,28969
6085,SANTA CLARA,2019,49,14559,15107,29666
6085,SANTA CLARA,2019,50,14122,14200,28322
6085,SANTA CLARA,2019,51,13520,13718,27238
6085,SANTA CLARA,2019,52,12868,13251,26119
6085,SANTA CLARA,2019,53,12948,13294,26242
6085,SANTA CLARA,2019,54,13308,13986,27294
6085,SANTA CLARA,2019,55,13221,14094,27315
6085,SANTA CLARA,2019,56,13427,13594,27021
6085,SANTA CLARA,2019,57,12901,13312,26213
6085,SANTA CLARA,2019,58,12930,13233,26163
6085,SANTA CLARA,2019,59,12893,13204,26097
6085,SANTA CLARA,2019,60,12336,12239,24575
6085,SANTA CLARA,2019,61,11732,12017,23749
6085,SANTA CLARA,2019,62,11569,11594,23163
6085,SANTA CLARA,2019,63,11395,11071,22466
6085,SANTA CLARA,2019,64,10918,10777,21695
6085,SANTA CLARA,2019,65,10354,9827,20181
6085,SANTA CLARA,2019,66,9888,9263,19151
6085,SANTA CLARA,2019,67,9424,8718,18142
6085,SANTA CLARA,2019,68,9220,8346,17566
6085,SANTA CLARA,2019,69,9202,8252,17454
6085,SANTA CLARA,2019,70,8793,7749,16542
6085,SANTA CLARA,2019,71,8365,7487,15852
6085,SANTA CLARA,2019,72,8473,7140,15613
6085,SANTA CLARA,2019,73,7077,6248,13325
6085,SANTA CLARA,2019,74,6746,5892,12638
6085,SANTA CLARA,2019,75,6528,5505,12033
6085,SANTA CLARA,2019,76,6241,5348,11589
6085,SANTA CLARA,2019,77,5646,4702,10348
6085,SANTA CLARA,2019,78,5387,4198,9585
6085,SANTA CLARA,2019,79,4894,3877,8771
6085,SANTA CLARA,2019,80,4783,3817,8600
6085,SANTA CLARA,2019,81,4495,3343,7838
6085,SANTA CLARA,2019,82,4111,3098,7209
6085,SANTA CLARA,2019,83,3735,2967,6702
6085,SANTA CLARA,2019,84,3600,2605,6205
6085,SANTA CLARA,2019,85,3319,2308,5627
6085,SANTA CLARA,2019,86,3162,2206,5368
6085,SANTA CLARA,2019,87,2849,1988,4837
6085,SANTA CLARA,2019,88,2767,1820,4587
6085,SANTA CLARA,2019,89,2380,1534,3914
6085,SANTA CLARA,2019,90,2137,1235,3372
6085,SANTA CLARA,2019,91,1872,1023,2895
6085,SANTA CLARA,2019,92,1592,813,2405
6085,SANTA CLARA,2019,93,1328,676,2004
6085,SANTA CLARA,2019,94,1068,530,1598
6085,SANTA CLARA,2019,95,750,413,1163
6085,SANTA CLARA,2019,96,605,276,881
6085,SANTA CLARA,2019,97,445,210,655
6085,SANTA CLARA,2019,98,322,146,468
6085,SANTA CLARA,2019,99,223,102,325
6085,SANTA CLARA,2019,100,316,104,420
6087,SANTA CRUZ,2017,0,1305,1436,2741
6087,SANTA CRUZ,2017,1,1406,1459,2865
6087,SANTA CRUZ,2017,2,1511,1614,3125
6087,SANTA CRUZ,2017,3,1562,1655,3217
6087,SANTA CRUZ,2017,4,1696,1727,3423
6087,SANTA CRUZ,2017,5,1814,1866,3680
6087,SANTA CRUZ,2017,6,1836,1830,3666
6087,SANTA CRUZ,2017,7,1632,1716,3348
6087,SANTA CRUZ,2017,8,1691,1763,3454
6087,SANTA CRUZ,2017,9,1706,1762,3468
6087,SANTA CRUZ,2017,10,1651,1768,3419
6087,SANTA CRUZ,2017,11,1485,1671,3156
6087,SANTA CRUZ,2017,12,1445,1507,2952
6087,SANTA CRUZ,2017,13,1486,1627,3113
6087,SANTA CRUZ,2017,14,1528,1530,3058
6087,SANTA CRUZ,2017,15,1478,1605,3083
6087,SANTA CRUZ,2017,16,1561,1588,3149
6087,SANTA CRUZ,2017,17,1593,1800,3393
6087,SANTA CRUZ,2017,18,3254,3116,6370
6087,SANTA CRUZ,2017,19,4089,4134,8223
6087,SANTA CRUZ,2017,20,3106,3280,6386
6087,SANTA CRUZ,2017,21,3244,3346,6590
6087,SANTA CRUZ,2017,22,2287,2418,4705
6087,SANTA CRUZ,2017,23,1954,2140,4094
6087,SANTA CRUZ,2017,24,2047,2207,4254
6087,SANTA CRUZ,2017,25,1853,2037,3890
6087,SANTA CRUZ,2017,26,1626,1712,3338
6087,SANTA CRUZ,2017,27,1615,1711,3326
6087,SANTA CRUZ,2017,28,1406,1554,2960
6087,SANTA CRUZ,2017,29,1332,1449,2781
6087,SANTA CRUZ,2017,30,1303,1510,2813
6087,SANTA CRUZ,2017,31,1206,1454,2660
6087,SANTA CRUZ,2017,32,1510,1601,3111
6087,SANTA CRUZ,2017,33,1540,1740,3280
6087,SANTA CRUZ,2017,34,1577,1753,3330
6087,SANTA CRUZ,2017,35,1667,1702,3369
6087,SANTA CRUZ,2017,36,1581,1692,3273
6087,SANTA CRUZ,2017,37,1622,1766,3388
6087,SANTA CRUZ,2017,38,1515,1575,3090
6087,SANTA CRUZ,2017,39,1531,1565,3096
6087,SANTA CRUZ,2017,40,1591,1551,3142
6087,SANTA CRUZ,2017,41,1486,1539,3025
6087,SANTA CRUZ,2017,42,1491,1560,3051
6087,SANTA CRUZ,2017,43,1404,1550,2954
6087,SANTA CRUZ,2017,44,1568,1554,3122
6087,SANTA CRUZ,2017,45,1482,1607,3089
6087,SANTA CRUZ,2017,46,1648,1640,3288
6087,SANTA CRUZ,2017,47,1725,1847,3572
6087,SANTA CRUZ,2017,48,1709,1750,3459
6087,SANTA CRUZ,2017,49,1694,1653,3347
6087,SANTA CRUZ,2017,50,1668,1622,3290
6087,SANTA CRUZ,2017,51,1625,1648,3273
6087,SANTA CRUZ,2017,52,1746,1731,3477
6087,SANTA CRUZ,2017,53,1827,1765,3592
6087,SANTA CRUZ,2017,54,1788,1840,3628
6087,SANTA CRUZ,2017,55,1853,1797,3650
6087,SANTA CRUZ,2017,56,1889,1762,3651
6087,SANTA CRUZ,2017,57,2005,1886,3891
6087,SANTA CRUZ,2017,58,1996,1847,3843
6087,SANTA CRUZ,2017,59,1970,1934,3904
6087,SANTA CRUZ,2017,60,2099,1889,3988
6087,SANTA CRUZ,2017,61,2058,1923,3981
6087,SANTA CRUZ,2017,62,2098,1913,4011
6087,SANTA CRUZ,2017,63,2004,1903,3907
6087,SANTA CRUZ,2017,64,1967,1930,3897
6087,SANTA CRUZ,2017,65,1878,1827,3705
6087,SANTA CRUZ,2017,66,1750,1780,3530
6087,SANTA CRUZ,2017,67,1780,1745,3525
6087,SANTA CRUZ,2017,68,1574,1619,3193
6087,SANTA CRUZ,2017,69,1575,1529,3104
6087,SANTA CRUZ,2017,70,1543,1484,3027
6087,SANTA CRUZ,2017,71,1243,1124,2367
6087,SANTA CRUZ,2017,72,1076,985,2061
6087,SANTA CRUZ,2017,73,986,927,1913
6087,SANTA CRUZ,2017,74,1004,847,1851
6087,SANTA CRUZ,2017,75,870,788,1658
6087,SANTA CRUZ,2017,76,678,603,1281
6087,SANTA CRUZ,2017,77,669,578,1247
6087,SANTA CRUZ,2017,78,630,506,1136
6087,SANTA CRUZ,2017,79,569,437,1006
6087,SANTA CRUZ,2017,80,520,461,981
6087,SANTA CRUZ,2017,81,510,446,956
6087,SANTA CRUZ,2017,82,442,336,778
6087,SANTA CRUZ,2017,83,445,291,736
6087,SANTA CRUZ,2017,84,461,295,756
6087,SANTA CRUZ,2017,85,447,263,710
6087,SANTA CRUZ,2017,86,395,199,594
6087,SANTA CRUZ,2017,87,387,256,643
6087,SANTA CRUZ,2017,88,373,189,562
6087,SANTA CRUZ,2017,89,335,170,505
6087,SANTA CRUZ,2017,90,303,120,423
6087,SANTA CRUZ,2017,91,246,102,348
6087,SANTA CRUZ,2017,92,193,117,310
6087,SANTA CRUZ,2017,93,171,70,241
6087,SANTA CRUZ,2017,94,128,60,188
6087,SANTA CRUZ,2017,95,95,40,135
6087,SANTA CRUZ,2017,96,64,29,93
6087,SANTA CRUZ,2017,97,35,6,41
6087,SANTA CRUZ,2017,98,13,10,23
6087,SANTA CRUZ,2017,99,9,0,9
6087,SANTA CRUZ,2017,100,29,1,30
6087,SANTA CRUZ,2018,0,1301,1358,2659
6087,SANTA CRUZ,2018,1,1298,1434,2732
6087,SANTA CRUZ,2018,2,1447,1519,2966
6087,SANTA CRUZ,2018,3,1585,1682,3267
6087,SANTA CRUZ,2018,4,1651,1699,3350
6087,SANTA CRUZ,2018,5,1709,1809,3518
6087,SANTA CRUZ,2018,6,1817,1865,3682
6087,SANTA CRUZ,2018,7,1840,1833,3673
6087,SANTA CRUZ,2018,8,1627,1714,3341
6087,SANTA CRUZ,2018,9,1694,1768,3462
6087,SANTA CRUZ,2018,10,1707,1766,3473
6087,SANTA CRUZ,2018,11,1658,1773,3431
6087,SANTA CRUZ,2018,12,1502,1695,3197
6087,SANTA CRUZ,2018,13,1446,1525,2971
6087,SANTA CRUZ,2018,14,1496,1640,3136
6087,SANTA CRUZ,2018,15,1553,1549,3102
6087,SANTA CRUZ,2018,16,1498,1610,3108
6087,SANTA CRUZ,2018,17,1670,1678,3348
6087,SANTA CRUZ,2018,18,3262,3282,6544
6087,SANTA CRUZ,2018,19,4023,4011,8034
6087,SANTA CRUZ,2018,20,3120,3379,6499
6087,SANTA CRUZ,2018,21,3204,3334,6538
6087,SANTA CRUZ,2018,22,2520,2581,5101
6087,SANTA CRUZ,2018,23,2002,2151,4153
6087,SANTA CRUZ,2018,24,1861,2030,3891
6087,SANTA CRUZ,2018,25,1709,1918,3627
6087,SANTA CRUZ,2018,26,1781,1903,3684
6087,SANTA CRUZ,2018,27,1616,1710,3326
6087,SANTA CRUZ,2018,28,1627,1745,3372
6087,SANTA CRUZ,2018,29,1390,1529,2919
6087,SANTA CRUZ,2018,30,1319,1440,2759
6087,SANTA CRUZ,2018,31,1313,1498,2811
6087,SANTA CRUZ,2018,32,1183,1418,2601
6087,SANTA CRUZ,2018,33,1515,1639,3154
6087,SANTA CRUZ,2018,34,1552,1728,3280
6087,SANTA CRUZ,2018,35,1581,1783,3364
6087,SANTA CRUZ,2018,36,1605,1643,3248
6087,SANTA CRUZ,2018,37,1592,1696,3288
6087,SANTA CRUZ,2018,38,1614,1772,3386
6087,SANTA CRUZ,2018,39,1520,1575,3095
6087,SANTA CRUZ,2018,40,1547,1560,3107
6087,SANTA CRUZ,2018,41,1582,1541,3123
6087,SANTA CRUZ,2018,42,1487,1564,3051
6087,SANTA CRUZ,2018,43,1477,1524,3001
6087,SANTA CRUZ,2018,44,1417,1538,2955
6087,SANTA CRUZ,2018,45,1564,1564,3128
6087,SANTA CRUZ,2018,46,1499,1619,3118
6087,SANTA CRUZ,2018,47,1630,1634,3264
6087,SANTA CRUZ,2018,48,1725,1853,3578
6087,SANTA CRUZ,2018,49,1711,1752,3463
6087,SANTA CRUZ,2018,50,1687,1642,3329
6087,SANTA CRUZ,2018,51,1663,1621,3284
6087,SANTA CRUZ,2018,52,1623,1629,3252
6087,SANTA CRUZ,2018,53,1751,1742,3493
6087,SANTA CRUZ,2018,54,1820,1741,3561
6087,SANTA CRUZ,2018,55,1778,1812,3590
6087,SANTA CRUZ,2018,56,1869,1802,3671
6087,SANTA CRUZ,2018,57,1903,1770,3673
6087,SANTA CRUZ,2018,58,2005,1878,3883
6087,SANTA CRUZ,2018,59,1981,1840,3821
6087,SANTA CRUZ,2018,60,1986,1950,3936
6087,SANTA CRUZ,2018,61,2070,1872,3942
6087,SANTA CRUZ,2018,62,2053,1909,3962
6087,SANTA CRUZ,2018,63,2071,1883,3954
6087,SANTA CRUZ,2018,64,1990,1887,3877
6087,SANTA CRUZ,2018,65,1948,1922,3870
6087,SANTA CRUZ,2018,66,1859,1793,3652
6087,SANTA CRUZ,2018,67,1738,1765,3503
6087,SANTA CRUZ,2018,68,1775,1721,3496
6087,SANTA CRUZ,2018,69,1557,1605,3162
6087,SANTA CRUZ,2018,70,1565,1501,3066
6087,SANTA CRUZ,2018,71,1528,1458,2986
6087,SANTA CRUZ,2018,72,1225,1107,2332
6087,SANTA CRUZ,2018,73,1047,963,2010
6087,SANTA CRUZ,2018,74,968,905,1873
6087,SANTA CRUZ,2018,75,990,835,1825
6087,SANTA CRUZ,2018,76,853,766,1619
6087,SANTA CRUZ,2018,77,665,590,1255
6087,SANTA CRUZ,2018,78,647,561,1208
6087,SANTA CRUZ,2018,79,620,481,1101
6087,SANTA CRUZ,2018,80,566,437,1003
6087,SANTA CRUZ,2018,81,492,445,937
6087,SANTA CRUZ,2018,82,491,419,910
6087,SANTA CRUZ,2018,83,431,319,750
6087,SANTA CRUZ,2018,84,423,276,699
6087,SANTA CRUZ,2018,85,481,286,767
6087,SANTA CRUZ,2018,86,412,237,649
6087,SANTA CRUZ,2018,87,374,185,559
6087,SANTA CRUZ,2018,88,355,235,590
6087,SANTA CRUZ,2018,89,326,166,492
6087,SANTA CRUZ,2018,90,315,150,465
6087,SANTA CRUZ,2018,91,264,87,351
6087,SANTA CRUZ,2018,92,205,90,295
6087,SANTA CRUZ,2018,93,155,84,239
6087,SANTA CRUZ,2018,94,160,58,218
6087,SANTA CRUZ,2018,95,111,49,160
6087,SANTA CRUZ,2018,96,73,23,96
6087,SANTA CRUZ,2018,97,53,21,74
6087,SANTA CRUZ,2018,98,19,4,23
6087,SANTA CRUZ,2018,99,9,6,15
6087,SANTA CRUZ,2018,100,22,0,22
6087,SANTA CRUZ,2019,0,1270,1510,2780
6087,SANTA CRUZ,2019,1,1289,1356,2645
6087,SANTA CRUZ,2019,2,1346,1480,2826
6087,SANTA CRUZ,2019,3,1527,1563,3090
6087,SANTA CRUZ,2019,4,1691,1733,3424
6087,SANTA CRUZ,2019,5,1661,1788,3449
6087,SANTA CRUZ,2019,6,1714,1807,3521
6087,SANTA CRUZ,2019,7,1822,1872,3694
6087,SANTA CRUZ,2019,8,1836,1829,3665
6087,SANTA CRUZ,2019,9,1627,1718,3345
6087,SANTA CRUZ,2019,10,1695,1773,3468
6087,SANTA CRUZ,2019,11,1718,1774,3492
6087,SANTA CRUZ,2019,12,1678,1789,3467
6087,SANTA CRUZ,2019,13,1502,1711,3213
6087,SANTA CRUZ,2019,14,1449,1546,2995
6087,SANTA CRUZ,2019,15,1520,1663,3183
6087,SANTA CRUZ,2019,16,1573,1549,3122
6087,SANTA CRUZ,2019,17,1613,1704,3317
6087,SANTA CRUZ,2019,18,3336,3160,6496
6087,SANTA CRUZ,2019,19,4022,4172,8194
6087,SANTA CRUZ,2019,20,3066,3258,6324
6087,SANTA CRUZ,2019,21,3219,3433,6652
6087,SANTA CRUZ,2019,22,2482,2578,5060
6087,SANTA CRUZ,2019,23,2224,2308,4532
6087,SANTA CRUZ,2019,24,1911,2048,3959
6087,SANTA CRUZ,2019,25,1526,1738,3264
6087,SANTA CRUZ,2019,26,1638,1783,3421
6087,SANTA CRUZ,2019,27,1774,1909,3683
6087,SANTA CRUZ,2019,28,1629,1736,3365
6087,SANTA CRUZ,2019,29,1604,1717,3321
6087,SANTA CRUZ,2019,30,1383,1517,2900
6087,SANTA CRUZ,2019,31,1331,1429,2760
6087,SANTA CRUZ,2019,32,1289,1463,2752
6087,SANTA CRUZ,2019,33,1193,1454,2647
6087,SANTA CRUZ,2019,34,1525,1629,3154
6087,SANTA CRUZ,2019,35,1559,1756,3315
6087,SANTA CRUZ,2019,36,1519,1723,3242
6087,SANTA CRUZ,2019,37,1617,1646,3263
6087,SANTA CRUZ,2019,38,1590,1705,3295
6087,SANTA CRUZ,2019,39,1625,1773,3398
6087,SANTA CRUZ,2019,40,1535,1570,3105
6087,SANTA CRUZ,2019,41,1535,1552,3087
6087,SANTA CRUZ,2019,42,1584,1568,3152
6087,SANTA CRUZ,2019,43,1475,1531,3006
6087,SANTA CRUZ,2019,44,1485,1512,2997
6087,SANTA CRUZ,2019,45,1413,1550,2963
6087,SANTA CRUZ,2019,46,1578,1574,3152
6087,SANTA CRUZ,2019,47,1485,1614,3099
6087,SANTA CRUZ,2019,48,1630,1642,3272
6087,SANTA CRUZ,2019,49,1728,1857,3585
6087,SANTA CRUZ,2019,50,1702,1746,3448
6087,SANTA CRUZ,2019,51,1684,1635,3319
6087,SANTA CRUZ,2019,52,1659,1604,3263
6087,SANTA CRUZ,2019,53,1626,1638,3264
6087,SANTA CRUZ,2019,54,1747,1723,3470
6087,SANTA CRUZ,2019,55,1813,1707,3520
6087,SANTA CRUZ,2019,56,1790,1819,3609
6087,SANTA CRUZ,2019,57,1885,1815,3700
6087,SANTA CRUZ,2019,58,1901,1766,3667
6087,SANTA CRUZ,2019,59,1991,1867,3858
6087,SANTA CRUZ,2019,60,1992,1860,3852
6087,SANTA CRUZ,2019,61,1970,1924,3894
6087,SANTA CRUZ,2019,62,2062,1855,3917
6087,SANTA CRUZ,2019,63,2028,1875,3903
6087,SANTA CRUZ,2019,64,2056,1863,3919
6087,SANTA CRUZ,2019,65,1976,1878,3854
6087,SANTA CRUZ,2019,66,1927,1871,3798
6087,SANTA CRUZ,2019,67,1843,1787,3630
6087,SANTA CRUZ,2019,68,1734,1725,3459
6087,SANTA CRUZ,2019,69,1755,1700,3455
6087,SANTA CRUZ,2019,70,1551,1588,3139
6087,SANTA CRUZ,2019,71,1557,1468,3025
6087,SANTA CRUZ,2019,72,1508,1437,2945
6087,SANTA CRUZ,2019,73,1204,1091,2295
6087,SANTA CRUZ,2019,74,1040,947,1987
6087,SANTA CRUZ,2019,75,941,893,1834
6087,SANTA CRUZ,2019,76,961,806,1767
6087,SANTA CRUZ,2019,77,841,744,1585
6087,SANTA CRUZ,2019,78,650,567,1217
6087,SANTA CRUZ,2019,79,638,550,1188
6087,SANTA CRUZ,2019,80,615,477,1092
6087,SANTA CRUZ,2019,81,543,414,957
6087,SANTA CRUZ,2019,82,467,417,884
6087,SANTA CRUZ,2019,83,481,394,875
6087,SANTA CRUZ,2019,84,413,299,712
6087,SANTA CRUZ,2019,85,441,269,710
6087,SANTA CRUZ,2019,86,450,263,713
6087,SANTA CRUZ,2019,87,387,228,615
6087,SANTA CRUZ,2019,88,352,166,518
6087,SANTA CRUZ,2019,89,314,211,525
6087,SANTA CRUZ,2019,90,302,152,454
6087,SANTA CRUZ,2019,91,267,111,378
6087,SANTA CRUZ,2019,92,224,70,294
6087,SANTA CRUZ,2019,93,169,77,246
6087,SANTA CRUZ,2019,94,141,59,200
6087,SANTA CRUZ,2019,95,127,43,170
6087,SANTA CRUZ,2019,96,79,34,113
6087,SANTA CRUZ,2019,97,62,18,80
6087,SANTA CRUZ,2019,98,34,14,48
6087,SANTA CRUZ,2019,99,15,2,17
6087,SANTA CRUZ,2019,100,15,5,20
6089,SHASTA,2017,0,922,1084,2006
6089,SHASTA,2017,1,982,1034,2016
6089,SHASTA,2017,2,946,1063,2009
6089,SHASTA,2017,3,1003,1009,2012
6089,SHASTA,2017,4,963,1023,1986
6089,SHASTA,2017,5,892,1026,1918
6089,SHASTA,2017,6,1001,1048,2049
6089,SHASTA,2017,7,991,1047,2038
6089,SHASTA,2017,8,955,1053,2008
6089,SHASTA,2017,9,1034,1077,2111
6089,SHASTA,2017,10,1073,1067,2140
6089,SHASTA,2017,11,1054,1119,2173
6089,SHASTA,2017,12,1087,1042,2129
6089,SHASTA,2017,13,1063,1075,2138
6089,SHASTA,2017,14,1068,1052,2120
6089,SHASTA,2017,15,1067,1146,2213
6089,SHASTA,2017,16,1079,1174,2253
6089,SHASTA,2017,17,1087,1180,2267
6089,SHASTA,2017,18,1097,1219,2316
6089,SHASTA,2017,19,1111,1212,2323
6089,SHASTA,2017,20,1143,1174,2317
6089,SHASTA,2017,21,1133,1274,2407
6089,SHASTA,2017,22,1082,1215,2297
6089,SHASTA,2017,23,1200,1218,2418
6089,SHASTA,2017,24,1118,1316,2434
6089,SHASTA,2017,25,1167,1195,2362
6089,SHASTA,2017,26,1160,1206,2366
6089,SHASTA,2017,27,1064,1227,2291
6089,SHASTA,2017,28,1047,1114,2161
6089,SHASTA,2017,29,1021,1038,2059
6089,SHASTA,2017,30,1019,1037,2056
6089,SHASTA,2017,31,994,1081,2075
6089,SHASTA,2017,32,1048,1186,2234
6089,SHASTA,2017,33,1089,1056,2145
6089,SHASTA,2017,34,1095,1086,2181
6089,SHASTA,2017,35,1024,1081,2105
6089,SHASTA,2017,36,1095,988,2083
6089,SHASTA,2017,37,1070,1090,2160
6089,SHASTA,2017,38,982,976,1958
6089,SHASTA,2017,39,954,961,1915
6089,SHASTA,2017,40,971,916,1887
6089,SHASTA,2017,41,872,949,1821
6089,SHASTA,2017,42,885,876,1761
6089,SHASTA,2017,43,842,829,1671
6089,SHASTA,2017,44,903,890,1793
6089,SHASTA,2017,45,922,865,1787
6089,SHASTA,2017,46,1071,971,2042
6089,SHASTA,2017,47,1129,1060,2189
6089,SHASTA,2017,48,991,990,1981
6089,SHASTA,2017,49,1043,968,2011
6089,SHASTA,2017,50,1041,962,2003
6089,SHASTA,2017,51,1065,1061,2126
6089,SHASTA,2017,52,1225,1079,2304
6089,SHASTA,2017,53,1287,1128,2415
6089,SHASTA,2017,54,1314,1119,2433
6089,SHASTA,2017,55,1326,1268,2594
6089,SHASTA,2017,56,1386,1271,2657
6089,SHASTA,2017,57,1321,1273,2594
6089,SHASTA,2017,58,1350,1215,2565
6089,SHASTA,2017,59,1381,1205,2586
6089,SHASTA,2017,60,1299,1153,2452
6089,SHASTA,2017,61,1330,1253,2583
6089,SHASTA,2017,62,1330,1135,2465
6089,SHASTA,2017,63,1327,1222,2549
6089,SHASTA,2017,64,1330,1180,2510
6089,SHASTA,2017,65,1299,1164,2463
6089,SHASTA,2017,66,1208,1057,2265
6089,SHASTA,2017,67,1242,1115,2357
6089,SHASTA,2017,68,1131,1091,2222
6089,SHASTA,2017,69,1259,1080,2339
6089,SHASTA,2017,70,1193,1103,2296
6089,SHASTA,2017,71,973,872,1845
6089,SHASTA,2017,72,915,839,1754
6089,SHASTA,2017,73,912,779,1691
6089,SHASTA,2017,74,971,818,1789
6089,SHASTA,2017,75,813,786,1599
6089,SHASTA,2017,76,755,649,1404
6089,SHASTA,2017,77,635,597,1232
6089,SHASTA,2017,78,636,570,1206
6089,SHASTA,2017,79,618,505,1123
6089,SHASTA,2017,80,609,487,1096
6089,SHASTA,2017,81,522,409,931
6089,SHASTA,2017,82,483,349,832
6089,SHASTA,2017,83,430,322,752
6089,SHASTA,2017,84,395,305,700
6089,SHASTA,2017,85,411,297,708
6089,SHASTA,2017,86,423,275,698
6089,SHASTA,2017,87,357,228,585
6089,SHASTA,2017,88,304,208,512
6089,SHASTA,2017,89,273,114,387
6089,SHASTA,2017,90,252,160,412
6089,SHASTA,2017,91,213,84,297
6089,SHASTA,2017,92,144,92,236
6089,SHASTA,2017,93,144,51,195
6089,SHASTA,2017,94,89,35,124
6089,SHASTA,2017,95,61,33,94
6089,SHASTA,2017,96,49,27,76
6089,SHASTA,2017,97,39,15,54
6089,SHASTA,2017,98,23,6,29
6089,SHASTA,2017,99,16,2,18
6089,SHASTA,2017,100,5,5,10
6089,SHASTA,2018,0,887,1097,1984
6089,SHASTA,2018,1,922,1077,1999
6089,SHASTA,2018,2,978,1034,2012
6089,SHASTA,2018,3,947,1067,2014
6089,SHASTA,2018,4,1009,1010,2019
6089,SHASTA,2018,5,966,1029,1995
6089,SHASTA,2018,6,905,1039,1944
6089,SHASTA,2018,7,1034,1064,2098
6089,SHASTA,2018,8,993,1048,2041
6089,SHASTA,2018,9,956,1061,2017
6089,SHASTA,2018,10,1045,1080,2125
6089,SHASTA,2018,11,1081,1068,2149
6089,SHASTA,2018,12,1056,1133,2189
6089,SHASTA,2018,13,1093,1050,2143
6089,SHASTA,2018,14,1067,1072,2139
6089,SHASTA,2018,15,1084,1058,2142
6089,SHASTA,2018,16,1065,1142,2207
6089,SHASTA,2018,17,1085,1197,2282
6089,SHASTA,2018,18,1133,1232,2365
6089,SHASTA,2018,19,1098,1206,2304
6089,SHASTA,2018,20,1073,1200,2273
6089,SHASTA,2018,21,1140,1155,2295
6089,SHASTA,2018,22,1121,1272,2393
6089,SHASTA,2018,23,1093,1200,2293
6089,SHASTA,2018,24,1175,1224,2399
6089,SHASTA,2018,25,1094,1293,2387
6089,SHASTA,2018,26,1181,1202,2383
6089,SHASTA,2018,27,1172,1220,2392
6089,SHASTA,2018,28,1075,1231,2306
6089,SHASTA,2018,29,1058,1121,2179
6089,SHASTA,2018,30,1032,1041,2073
6089,SHASTA,2018,31,1025,1063,2088
6089,SHASTA,2018,32,1002,1075,2077
6089,SHASTA,2018,33,1046,1190,2236
6089,SHASTA,2018,34,1102,1067,2169
6089,SHASTA,2018,35,1100,1084,2184
6089,SHASTA,2018,36,1032,1087,2119
6089,SHASTA,2018,37,1091,1007,2098
6089,SHASTA,2018,38,1073,1080,2153
6089,SHASTA,2018,39,989,982,1971
6089,SHASTA,2018,40,963,972,1935
6089,SHASTA,2018,41,962,920,1882
6089,SHASTA,2018,42,872,945,1817
6089,SHASTA,2018,43,887,877,1764
6089,SHASTA,2018,44,856,820,1676
6089,SHASTA,2018,45,895,873,1768
6089,SHASTA,2018,46,920,892,1812
6089,SHASTA,2018,47,1078,982,2060
6089,SHASTA,2018,48,1139,1070,2209
6089,SHASTA,2018,49,999,986,1985
6089,SHASTA,2018,50,1047,959,2006
6089,SHASTA,2018,51,1043,956,1999
6089,SHASTA,2018,52,1058,1035,2093
6089,SHASTA,2018,53,1213,1073,2286
6089,SHASTA,2018,54,1277,1113,2390
6089,SHASTA,2018,55,1306,1115,2421
6089,SHASTA,2018,56,1312,1252,2564
6089,SHASTA,2018,57,1376,1253,2629
6089,SHASTA,2018,58,1294,1243,2537
6089,SHASTA,2018,59,1341,1196,2537
6089,SHASTA,2018,60,1366,1191,2557
6089,SHASTA,2018,61,1286,1119,2405
6089,SHASTA,2018,62,1320,1253,2573
6089,SHASTA,2018,63,1325,1112,2437
6089,SHASTA,2018,64,1321,1204,2525
6089,SHASTA,2018,65,1314,1169,2483
6089,SHASTA,2018,66,1281,1133,2414
6089,SHASTA,2018,67,1196,1039,2235
6089,SHASTA,2018,68,1209,1110,2319
6089,SHASTA,2018,69,1124,1072,2196
6089,SHASTA,2018,70,1243,1042,2285
6089,SHASTA,2018,71,1158,1068,2226
6089,SHASTA,2018,72,946,837,1783
6089,SHASTA,2018,73,900,811,1711
6089,SHASTA,2018,74,882,748,1630
6089,SHASTA,2018,75,949,807,1756
6089,SHASTA,2018,76,783,749,1532
6089,SHASTA,2018,77,738,627,1365
6089,SHASTA,2018,78,611,574,1185
6089,SHASTA,2018,79,618,549,1167
6089,SHASTA,2018,80,588,490,1078
6089,SHASTA,2018,81,589,450,1039
6089,SHASTA,2018,82,475,391,866
6089,SHASTA,2018,83,462,318,780
6089,SHASTA,2018,84,402,294,696
6089,SHASTA,2018,85,409,289,698
6089,SHASTA,2018,86,371,269,640
6089,SHASTA,2018,87,379,241,620
6089,SHASTA,2018,88,325,202,527
6089,SHASTA,2018,89,276,177,453
6089,SHASTA,2018,90,247,107,354
6089,SHASTA,2018,91,197,132,329
6089,SHASTA,2018,92,176,66,242
6089,SHASTA,2018,93,133,66,199
6089,SHASTA,2018,94,112,46,158
6089,SHASTA,2018,95,74,28,102
6089,SHASTA,2018,96,39,21,60
6089,SHASTA,2018,97,37,19,56
6089,SHASTA,2018,98,26,9,35
6089,SHASTA,2018,99,16,2,18
6089,SHASTA,2018,100,13,4,17
6089,SHASTA,2019,0,944,1016,1960
6089,SHASTA,2019,1,888,1088,1976
6089,SHASTA,2019,2,923,1081,2004
6089,SHASTA,2019,3,979,1039,2018
6089,SHASTA,2019,4,955,1066,2021
6089,SHASTA,2019,5,1010,1016,2026
6089,SHASTA,2019,6,974,1044,2018
6089,SHASTA,2019,7,935,1052,1987
6089,SHASTA,2019,8,1036,1065,2101
6089,SHASTA,2019,9,998,1058,2056
6089,SHASTA,2019,10,979,1074,2053
6089,SHASTA,2019,11,1051,1081,2132
6089,SHASTA,2019,12,1082,1084,2166
6089,SHASTA,2019,13,1065,1142,2207
6089,SHASTA,2019,14,1096,1054,2150
6089,SHASTA,2019,15,1080,1084,2164
6089,SHASTA,2019,16,1080,1058,2138
6089,SHASTA,2019,17,1073,1163,2236
6089,SHASTA,2019,18,1139,1248,2387
6089,SHASTA,2019,19,1136,1218,2354
6089,SHASTA,2019,20,1063,1195,2258
6089,SHASTA,2019,21,1072,1181,2253
6089,SHASTA,2019,22,1132,1158,2290
6089,SHASTA,2019,23,1132,1254,2386
6089,SHASTA,2019,24,1071,1205,2276
6089,SHASTA,2019,25,1151,1197,2348
6089,SHASTA,2019,26,1109,1316,2425
6089,SHASTA,2019,27,1199,1211,2410
6089,SHASTA,2019,28,1186,1224,2410
6089,SHASTA,2019,29,1091,1242,2333
6089,SHASTA,2019,30,1065,1123,2188
6089,SHASTA,2019,31,1041,1067,2108
6089,SHASTA,2019,32,1044,1064,2108
6089,SHASTA,2019,33,1000,1082,2082
6089,SHASTA,2019,34,1068,1197,2265
6089,SHASTA,2019,35,1111,1059,2170
6089,SHASTA,2019,36,1104,1096,2200
6089,SHASTA,2019,37,1034,1106,2140
6089,SHASTA,2019,38,1095,998,2093
6089,SHASTA,2019,39,1081,1082,2163
6089,SHASTA,2019,40,1001,992,1993
6089,SHASTA,2019,41,951,970,1921
6089,SHASTA,2019,42,962,921,1883
6089,SHASTA,2019,43,870,944,1814
6089,SHASTA,2019,44,902,869,1771
6089,SHASTA,2019,45,853,806,1659
6089,SHASTA,2019,46,902,895,1797
6089,SHASTA,2019,47,931,907,1838
6089,SHASTA,2019,48,1092,999,2091
6089,SHASTA,2019,49,1151,1065,2216
6089,SHASTA,2019,50,1007,981,1988
6089,SHASTA,2019,51,1042,947,1989
6089,SHASTA,2019,52,1038,942,1980
6089,SHASTA,2019,53,1050,1027,2077
6089,SHASTA,2019,54,1195,1064,2259
6089,SHASTA,2019,55,1279,1107,2386
6089,SHASTA,2019,56,1288,1101,2389
6089,SHASTA,2019,57,1298,1236,2534
6089,SHASTA,2019,58,1352,1229,2581
6089,SHASTA,2019,59,1283,1227,2510
6089,SHASTA,2019,60,1330,1172,2502
6089,SHASTA,2019,61,1353,1165,2518
6089,SHASTA,2019,62,1279,1109,2388
6089,SHASTA,2019,63,1312,1223,2535
6089,SHASTA,2019,64,1324,1093,2417
6089,SHASTA,2019,65,1313,1185,2498
6089,SHASTA,2019,66,1293,1150,2443
6089,SHASTA,2019,67,1267,1122,2389
6089,SHASTA,2019,68,1165,1032,2197
6089,SHASTA,2019,69,1200,1092,2292
6089,SHASTA,2019,70,1109,1038,2147
6089,SHASTA,2019,71,1210,1013,2223
6089,SHASTA,2019,72,1135,1031,2166
6089,SHASTA,2019,73,939,814,1753
6089,SHASTA,2019,74,874,775,1649
6089,SHASTA,2019,75,870,740,1610
6089,SHASTA,2019,76,919,776,1695
6089,SHASTA,2019,77,758,726,1484
6089,SHASTA,2019,78,704,596,1300
6089,SHASTA,2019,79,600,552,1152
6089,SHASTA,2019,80,592,533,1125
6089,SHASTA,2019,81,560,460,1020
6089,SHASTA,2019,82,552,420,972
6089,SHASTA,2019,83,452,355,807
6089,SHASTA,2019,84,433,297,730
6089,SHASTA,2019,85,397,274,671
6089,SHASTA,2019,86,367,261,628
6089,SHASTA,2019,87,322,239,561
6089,SHASTA,2019,88,344,224,568
6089,SHASTA,2019,89,284,175,459
6089,SHASTA,2019,90,249,153,402
6089,SHASTA,2019,91,206,74,280
6089,SHASTA,2019,92,158,97,255
6089,SHASTA,2019,93,163,49,212
6089,SHASTA,2019,94,105,52,157
6089,SHASTA,2019,95,92,38,130
6089,SHASTA,2019,96,46,20,66
6089,SHASTA,2019,97,28,13,41
6089,SHASTA,2019,98,28,14,42
6089,SHASTA,2019,99,19,2,21
6089,SHASTA,2019,100,16,3,19
6091,SIERRA,2017,0,18,10,28
6091,SIERRA,2017,1,22,11,33
6091,SIERRA,2017,2,6,12,18
6091,SIERRA,2017,3,6,15,21
6091,SIERRA,2017,4,12,11,23
6091,SIERRA,2017,5,14,8,22
6091,SIERRA,2017,6,9,11,20
6091,SIERRA,2017,7,15,19,34
6091,SIERRA,2017,8,11,11,22
6091,SIERRA,2017,9,19,15,34
6091,SIERRA,2017,10,15,15,30
6091,SIERRA,2017,11,13,12,25
6091,SIERRA,2017,12,8,14,22
6091,SIERRA,2017,13,10,14,24
6091,SIERRA,2017,14,14,13,27
6091,SIERRA,2017,15,16,12,28
6091,SIERRA,2017,16,12,17,29
6091,SIERRA,2017,17,16,8,24
6091,SIERRA,2017,18,13,17,30
6091,SIERRA,2017,19,13,25,38
6091,SIERRA,2017,20,15,14,29
6091,SIERRA,2017,21,10,25,35
6091,SIERRA,2017,22,21,22,43
6091,SIERRA,2017,23,20,20,40
6091,SIERRA,2017,24,24,17,41
6091,SIERRA,2017,25,13,22,35
6091,SIERRA,2017,26,4,16,20
6091,SIERRA,2017,27,9,10,19
6091,SIERRA,2017,28,7,12,19
6091,SIERRA,2017,29,10,16,26
6091,SIERRA,2017,30,17,11,28
6091,SIERRA,2017,31,13,13,26
6091,SIERRA,2017,32,12,11,23
6091,SIERRA,2017,33,9,14,23
6091,SIERRA,2017,34,5,10,15
6091,SIERRA,2017,35,16,15,31
6091,SIERRA,2017,36,17,17,34
6091,SIERRA,2017,37,8,7,15
6091,SIERRA,2017,38,11,14,25
6091,SIERRA,2017,39,12,7,19
6091,SIERRA,2017,40,17,13,30
6091,SIERRA,2017,41,10,10,20
6091,SIERRA,2017,42,17,12,29
6091,SIERRA,2017,43,12,9,21
6091,SIERRA,2017,44,14,13,27
6091,SIERRA,2017,45,20,23,43
6091,SIERRA,2017,46,11,17,28
6091,SIERRA,2017,47,20,17,37
6091,SIERRA,2017,48,15,18,33
6091,SIERRA,2017,49,18,19,37
6091,SIERRA,2017,50,18,17,35
6091,SIERRA,2017,51,21,17,38
6091,SIERRA,2017,52,18,21,39
6091,SIERRA,2017,53,26,22,48
6091,SIERRA,2017,54,29,14,43
6091,SIERRA,2017,55,26,39,65
6091,SIERRA,2017,56,34,20,54
6091,SIERRA,2017,57,19,35,54
6091,SIERRA,2017,58,30,34,64
6091,SIERRA,2017,59,39,28,67
6091,SIERRA,2017,60,24,26,50
6091,SIERRA,2017,61,32,29,61
6091,SIERRA,2017,62,36,19,55
6091,SIERRA,2017,63,29,29,58
6091,SIERRA,2017,64,40,33,73
6091,SIERRA,2017,65,35,35,70
6091,SIERRA,2017,66,30,39,69
6091,SIERRA,2017,67,31,25,56
6091,SIERRA,2017,68,33,32,65
6091,SIERRA,2017,69,29,39,68
6091,SIERRA,2017,70,35,33,68
6091,SIERRA,2017,71,25,30,55
6091,SIERRA,2017,72,16,28,44
6091,SIERRA,2017,73,20,16,36
6091,SIERRA,2017,74,20,19,39
6091,SIERRA,2017,75,21,20,41
6091,SIERRA,2017,76,16,23,39
6091,SIERRA,2017,77,22,19,41
6091,SIERRA,2017,78,16,16,32
6091,SIERRA,2017,79,13,14,27
6091,SIERRA,2017,80,16,9,25
6091,SIERRA,2017,81,14,7,21
6091,SIERRA,2017,82,12,10,22
6091,SIERRA,2017,83,9,6,15
6091,SIERRA,2017,84,9,16,25
6091,SIERRA,2017,85,14,7,21
6091,SIERRA,2017,86,10,7,17
6091,SIERRA,2017,87,6,6,12
6091,SIERRA,2017,88,4,5,9
6091,SIERRA,2017,89,3,3,6
6091,SIERRA,2017,90,2,7,9
6091,SIERRA,2017,92,0,3,3
6091,SIERRA,2017,93,1,0,1
6091,SIERRA,2017,94,0,3,3
6091,SIERRA,2017,95,3,1,4
6091,SIERRA,2017,96,2,2,4
6091,SIERRA,2017,99,2,1,3
6091,SIERRA,2017,100,0,1,1
6091,SIERRA,2018,0,13,14,27
6091,SIERRA,2018,1,18,10,28
6091,SIERRA,2018,2,22,11,33
6091,SIERRA,2018,3,6,12,18
6091,SIERRA,2018,4,6,15,21
6091,SIERRA,2018,5,12,11,23
6091,SIERRA,2018,6,15,8,23
6091,SIERRA,2018,7,9,11,20
6091,SIERRA,2018,8,15,19,34
6091,SIERRA,2018,9,11,11,22
6091,SIERRA,2018,10,19,15,34
6091,SIERRA,2018,11,15,15,30
6091,SIERRA,2018,12,13,12,25
6091,SIERRA,2018,13,9,14,23
6091,SIERRA,2018,14,10,14,24
6091,SIERRA,2018,15,14,13,27
6091,SIERRA,2018,16,16,12,28
6091,SIERRA,2018,17,12,17,29
6091,SIERRA,2018,18,16,9,25
6091,SIERRA,2018,19,13,17,30
6091,SIERRA,2018,20,13,25,38
6091,SIERRA,2018,21,15,14,29
6091,SIERRA,2018,22,10,25,35
6091,SIERRA,2018,23,22,22,44
6091,SIERRA,2018,24,21,19,40
6091,SIERRA,2018,25,23,17,40
6091,SIERRA,2018,26,12,23,35
6091,SIERRA,2018,27,4,16,20
6091,SIERRA,2018,28,9,10,19
6091,SIERRA,2018,29,7,12,19
6091,SIERRA,2018,30,10,16,26
6091,SIERRA,2018,31,17,11,28
6091,SIERRA,2018,32,13,13,26
6091,SIERRA,2018,33,12,12,24
6091,SIERRA,2018,34,9,14,23
6091,SIERRA,2018,35,5,10,15
6091,SIERRA,2018,36,16,15,31
6091,SIERRA,2018,37,17,17,34
6091,SIERRA,2018,38,8,7,15
6091,SIERRA,2018,39,11,14,25
6091,SIERRA,2018,40,12,7,19
6091,SIERRA,2018,41,16,13,29
6091,SIERRA,2018,42,10,10,20
6091,SIERRA,2018,43,17,12,29
6091,SIERRA,2018,44,12,9,21
6091,SIERRA,2018,45,14,14,28
6091,SIERRA,2018,46,20,23,43
6091,SIERRA,2018,47,11,17,28
6091,SIERRA,2018,48,20,18,38
6091,SIERRA,2018,49,15,17,32
6091,SIERRA,2018,50,20,19,39
6091,SIERRA,2018,51,16,17,33
6091,SIERRA,2018,52,21,17,38
6091,SIERRA,2018,53,18,22,40
6091,SIERRA,2018,54,26,21,47
6091,SIERRA,2018,55,29,14,43
6091,SIERRA,2018,56,27,39,66
6091,SIERRA,2018,57,33,20,53
6091,SIERRA,2018,58,22,35,57
6091,SIERRA,2018,59,27,33,60
6091,SIERRA,2018,60,39,28,67
6091,SIERRA,2018,61,27,26,53
6091,SIERRA,2018,62,29,30,59
6091,SIERRA,2018,63,36,17,53
6091,SIERRA,2018,64,28,29,57
6091,SIERRA,2018,65,42,34,76
6091,SIERRA,2018,66,33,34,67
6091,SIERRA,2018,67,30,38,68
6091,SIERRA,2018,68,31,25,56
6091,SIERRA,2018,69,34,29,63
6091,SIERRA,2018,70,28,38,66
6091,SIERRA,2018,71,35,33,68
6091,SIERRA,2018,72,22,30,52
6091,SIERRA,2018,73,16,26,42
6091,SIERRA,2018,74,19,16,35
6091,SIERRA,2018,75,19,19,38
6091,SIERRA,2018,76,21,20,41
6091,SIERRA,2018,77,16,23,39
6091,SIERRA,2018,78,22,18,40
6091,SIERRA,2018,79,16,17,33
6091,SIERRA,2018,80,14,13,27
6091,SIERRA,2018,81,13,8,21
6091,SIERRA,2018,82,13,7,20
6091,SIERRA,2018,83,12,9,21
6091,SIERRA,2018,84,8,6,14
6091,SIERRA,2018,85,9,17,26
6091,SIERRA,2018,86,12,5,17
6091,SIERRA,2018,87,10,7,17
6091,SIERRA,2018,88,5,7,12
6091,SIERRA,2018,89,3,3,6
6091,SIERRA,2018,90,3,3,6
6091,SIERRA,2018,91,1,7,8
6091,SIERRA,2018,93,0,2,2
6091,SIERRA,2018,94,1,2,3
6091,SIERRA,2018,95,0,1,1
6091,SIERRA,2018,96,4,1,5
6091,SIERRA,2018,97,1,1,2
6091,SIERRA,2018,99,1,0,1
6091,SIERRA,2018,100,1,1,2
6091,SIERRA,2019,0,13,14,27
6091,SIERRA,2019,1,13,14,27
6091,SIERRA,2019,2,18,10,28
6091,SIERRA,2019,3,22,11,33
6091,SIERRA,2019,4,6,12,18
6091,SIERRA,2019,5,6,15,21
6091,SIERRA,2019,6,12,11,23
6091,SIERRA,2019,7,15,8,23
6091,SIERRA,2019,8,10,11,21
6091,SIERRA,2019,9,15,19,34
6091,SIERRA,2019,10,11,11,22
6091,SIERRA,2019,11,19,15,34
6091,SIERRA,2019,12,16,15,31
6091,SIERRA,2019,13,13,12,25
6091,SIERRA,2019,14,9,14,23
6091,SIERRA,2019,15,10,14,24
6091,SIERRA,2019,16,14,13,27
6091,SIERRA,2019,17,16,11,27
6091,SIERRA,2019,18,12,17,29
6091,SIERRA,2019,19,16,9,25
6091,SIERRA,2019,20,14,17,31
6091,SIERRA,2019,21,13,26,39
6091,SIERRA,2019,22,15,14,29
6091,SIERRA,2019,23,10,25,35
6091,SIERRA,2019,24,23,22,45
6091,SIERRA,2019,25,20,18,38
6091,SIERRA,2019,26,23,17,40
6091,SIERRA,2019,27,12,23,35
6091,SIERRA,2019,28,4,17,21
6091,SIERRA,2019,29,9,9,18
6091,SIERRA,2019,30,7,12,19
6091,SIERRA,2019,31,10,16,26
6091,SIERRA,2019,32,17,11,28
6091,SIERRA,2019,33,13,13,26
6091,SIERRA,2019,34,12,13,25
6091,SIERRA,2019,35,9,14,23
6091,SIERRA,2019,36,5,10,15
6091,SIERRA,2019,37,16,15,31
6091,SIERRA,2019,38,17,17,34
6091,SIERRA,2019,39,8,7,15
6091,SIERRA,2019,40,11,14,25
6091,SIERRA,2019,41,12,8,20
6091,SIERRA,2019,42,16,13,29
6091,SIERRA,2019,43,10,10,20
6091,SIERRA,2019,44,17,12,29
6091,SIERRA,2019,45,12,9,21
6091,SIERRA,2019,46,14,14,28
6091,SIERRA,2019,47,20,23,43
6091,SIERRA,2019,48,11,18,29
6091,SIERRA,2019,49,20,16,36
6091,SIERRA,2019,50,16,17,33
6091,SIERRA,2019,51,18,19,37
6091,SIERRA,2019,52,16,17,33
6091,SIERRA,2019,53,21,18,39
6091,SIERRA,2019,54,18,21,39
6091,SIERRA,2019,55,26,21,47
6091,SIERRA,2019,56,30,14,44
6091,SIERRA,2019,57,26,39,65
6091,SIERRA,2019,58,36,20,56
6091,SIERRA,2019,59,19,35,54
6091,SIERRA,2019,60,27,32,59
6091,SIERRA,2019,61,42,28,70
6091,SIERRA,2019,62,23,27,50
6091,SIERRA,2019,63,28,29,57
6091,SIERRA,2019,64,36,17,53
6091,SIERRA,2019,65,30,30,60
6091,SIERRA,2019,66,40,33,73
6091,SIERRA,2019,67,33,33,66
6091,SIERRA,2019,68,30,38,68
6091,SIERRA,2019,69,32,25,57
6091,SIERRA,2019,70,32,29,61
6091,SIERRA,2019,71,28,38,66
6091,SIERRA,2019,72,35,33,68
6091,SIERRA,2019,73,21,30,51
6091,SIERRA,2019,74,16,25,41
6091,SIERRA,2019,75,18,16,34
6091,SIERRA,2019,76,19,19,38
6091,SIERRA,2019,77,20,19,39
6091,SIERRA,2019,78,14,22,36
6091,SIERRA,2019,79,22,19,41
6091,SIERRA,2019,80,17,17,34
6091,SIERRA,2019,81,11,11,22
6091,SIERRA,2019,82,11,8,19
6091,SIERRA,2019,83,11,7,18
6091,SIERRA,2019,84,12,9,21
6091,SIERRA,2019,85,8,6,14
6091,SIERRA,2019,86,6,15,21
6091,SIERRA,2019,87,13,4,17
6091,SIERRA,2019,88,10,8,18
6091,SIERRA,2019,89,3,5,8
6091,SIERRA,2019,90,4,2,6
6091,SIERRA,2019,91,2,3,5
6091,SIERRA,2019,92,1,4,5
6091,SIERRA,2019,94,0,4,4
6091,SIERRA,2019,95,1,0,1
6091,SIERRA,2019,96,1,1,2
6091,SIERRA,2019,97,3,1,4
6091,SIERRA,2019,99,1,0,1
6091,SIERRA,2019,100,1,1,2
6093,SISKIYOU,2017,0,212,241,453
6093,SISKIYOU,2017,1,204,235,439
6093,SISKIYOU,2017,2,206,231,437
6093,SISKIYOU,2017,3,233,229,462
6093,SISKIYOU,2017,4,240,224,464
6093,SISKIYOU,2017,5,248,247,495
6093,SISKIYOU,2017,6,232,231,463
6093,SISKIYOU,2017,7,223,203,426
6093,SISKIYOU,2017,8,231,271,502
6093,SISKIYOU,2017,9,219,272,491
6093,SISKIYOU,2017,10,257,293,550
6093,SISKIYOU,2017,11,219,235,454
6093,SISKIYOU,2017,12,247,243,490
6093,SISKIYOU,2017,13,263,254,517
6093,SISKIYOU,2017,14,213,247,460
6093,SISKIYOU,2017,15,243,243,486
6093,SISKIYOU,2017,16,234,226,460
6093,SISKIYOU,2017,17,284,276,560
6093,SISKIYOU,2017,18,278,276,554
6093,SISKIYOU,2017,19,274,303,577
6093,SISKIYOU,2017,20,257,295,552
6093,SISKIYOU,2017,21,266,324,590
6093,SISKIYOU,2017,22,238,288,526
6093,SISKIYOU,2017,23,246,321,567
6093,SISKIYOU,2017,24,270,312,582
6093,SISKIYOU,2017,25,261,299,560
6093,SISKIYOU,2017,26,206,266,472
6093,SISKIYOU,2017,27,238,268,506
6093,SISKIYOU,2017,28,191,229,420
6093,SISKIYOU,2017,29,200,214,414
6093,SISKIYOU,2017,30,216,217,433
6093,SISKIYOU,2017,31,196,219,415
6093,SISKIYOU,2017,32,218,256,474
6093,SISKIYOU,2017,33,227,241,468
6093,SISKIYOU,2017,34,215,218,433
6093,SISKIYOU,2017,35,232,211,443
6093,SISKIYOU,2017,36,210,235,445
6093,SISKIYOU,2017,37,226,236,462
6093,SISKIYOU,2017,38,185,216,401
6093,SISKIYOU,2017,39,190,191,381
6093,SISKIYOU,2017,40,174,192,366
6093,SISKIYOU,2017,41,179,192,371
6093,SISKIYOU,2017,42,210,208,418
6093,SISKIYOU,2017,43,194,199,393
6093,SISKIYOU,2017,44,176,196,372
6093,SISKIYOU,2017,45,199,229,428
6093,SISKIYOU,2017,46,238,234,472
6093,SISKIYOU,2017,47,261,236,497
6093,SISKIYOU,2017,48,244,267,511
6093,SISKIYOU,2017,49,201,217,418
6093,SISKIYOU,2017,50,241,203,444
6093,SISKIYOU,2017,51,237,237,474
6093,SISKIYOU,2017,52,253,216,469
6093,SISKIYOU,2017,53,286,271,557
6093,SISKIYOU,2017,54,293,292,585
6093,SISKIYOU,2017,55,303,301,604
6093,SISKIYOU,2017,56,374,315,689
6093,SISKIYOU,2017,57,349,283,632
6093,SISKIYOU,2017,58,351,285,636
6093,SISKIYOU,2017,59,402,331,733
6093,SISKIYOU,2017,60,420,355,775
6093,SISKIYOU,2017,61,396,377,773
6093,SISKIYOU,2017,62,386,378,764
6093,SISKIYOU,2017,63,359,341,700
6093,SISKIYOU,2017,64,445,330,775
6093,SISKIYOU,2017,65,397,389,786
6093,SISKIYOU,2017,66,375,348,723
6093,SISKIYOU,2017,67,366,349,715
6093,SISKIYOU,2017,68,375,353,728
6093,SISKIYOU,2017,69,352,353,705
6093,SISKIYOU,2017,70,374,378,752
6093,SISKIYOU,2017,71,273,280,553
6093,SISKIYOU,2017,72,307,268,575
6093,SISKIYOU,2017,73,284,286,570
6093,SISKIYOU,2017,74,252,281,533
6093,SISKIYOU,2017,75,244,231,475
6093,SISKIYOU,2017,76,188,226,414
6093,SISKIYOU,2017,77,205,205,410
6093,SISKIYOU,2017,78,167,151,318
6093,SISKIYOU,2017,79,147,154,301
6093,SISKIYOU,2017,80,176,171,347
6093,SISKIYOU,2017,81,148,116,264
6093,SISKIYOU,2017,82,141,123,264
6093,SISKIYOU,2017,83,126,93,219
6093,SISKIYOU,2017,84,122,94,216
6093,SISKIYOU,2017,85,114,71,185
6093,SISKIYOU,2017,86,102,86,188
6093,SISKIYOU,2017,87,87,61,148
6093,SISKIYOU,2017,88,104,74,178
6093,SISKIYOU,2017,89,69,55,124
6093,SISKIYOU,2017,90,76,47,123
6093,SISKIYOU,2017,91,62,25,87
6093,SISKIYOU,2017,92,57,37,94
6093,SISKIYOU,2017,93,35,18,53
6093,SISKIYOU,2017,94,26,14,40
6093,SISKIYOU,2017,95,30,9,39
6093,SISKIYOU,2017,96,16,10,26
6093,SISKIYOU,2017,97,6,2,8
6093,SISKIYOU,2017,98,10,0,10
6093,SISKIYOU,2017,99,0,2,2
6093,SISKIYOU,2017,100,11,1,12
6093,SISKIYOU,2018,0,206,255,461
6093,SISKIYOU,2018,1,214,240,454
6093,SISKIYOU,2018,2,204,236,440
6093,SISKIYOU,2018,3,207,231,438
6093,SISKIYOU,2018,4,233,229,462
6093,SISKIYOU,2018,5,240,224,464
6093,SISKIYOU,2018,6,248,247,495
6093,SISKIYOU,2018,7,233,230,463
6093,SISKIYOU,2018,8,224,205,429
6093,SISKIYOU,2018,9,231,272,503
6093,SISKIYOU,2018,10,219,272,491
6093,SISKIYOU,2018,11,257,294,551
6093,SISKIYOU,2018,12,219,236,455
6093,SISKIYOU,2018,13,247,245,492
6093,SISKIYOU,2018,14,263,251,514
6093,SISKIYOU,2018,15,213,250,463
6093,SISKIYOU,2018,16,243,243,486
6093,SISKIYOU,2018,17,236,237,473
6093,SISKIYOU,2018,18,290,287,577
6093,SISKIYOU,2018,19,281,292,573
6093,SISKIYOU,2018,20,268,283,551
6093,SISKIYOU,2018,21,258,298,556
6093,SISKIYOU,2018,22,267,316,583
6093,SISKIYOU,2018,23,241,290,531
6093,SISKIYOU,2018,24,243,319,562
6093,SISKIYOU,2018,25,270,316,586
6093,SISKIYOU,2018,26,262,307,569
6093,SISKIYOU,2018,27,210,263,473
6093,SISKIYOU,2018,28,237,270,507
6093,SISKIYOU,2018,29,193,222,415
6093,SISKIYOU,2018,30,202,219,421
6093,SISKIYOU,2018,31,215,215,430
6093,SISKIYOU,2018,32,199,220,419
6093,SISKIYOU,2018,33,217,264,481
6093,SISKIYOU,2018,34,229,229,458
6093,SISKIYOU,2018,35,218,219,437
6093,SISKIYOU,2018,36,233,220,453
6093,SISKIYOU,2018,37,208,228,436
6093,SISKIYOU,2018,38,225,243,468
6093,SISKIYOU,2018,39,189,213,402
6093,SISKIYOU,2018,40,191,190,381
6093,SISKIYOU,2018,41,174,196,370
6093,SISKIYOU,2018,42,182,200,382
6093,SISKIYOU,2018,43,209,204,413
6093,SISKIYOU,2018,44,197,201,398
6093,SISKIYOU,2018,45,177,194,371
6093,SISKIYOU,2018,46,198,227,425
6093,SISKIYOU,2018,47,237,239,476
6093,SISKIYOU,2018,48,260,232,492
6093,SISKIYOU,2018,49,244,260,504
6093,SISKIYOU,2018,50,204,217,421
6093,SISKIYOU,2018,51,240,198,438
6093,SISKIYOU,2018,52,233,243,476
6093,SISKIYOU,2018,53,252,204,456
6093,SISKIYOU,2018,54,285,266,551
6093,SISKIYOU,2018,55,293,290,583
6093,SISKIYOU,2018,56,307,298,605
6093,SISKIYOU,2018,57,367,308,675
6093,SISKIYOU,2018,58,351,280,631
6093,SISKIYOU,2018,59,350,282,632
6093,SISKIYOU,2018,60,402,329,731
6093,SISKIYOU,2018,61,417,351,768
6093,SISKIYOU,2018,62,394,367,761
6093,SISKIYOU,2018,63,385,372,757
6093,SISKIYOU,2018,64,356,330,686
6093,SISKIYOU,2018,65,438,326,764
6093,SISKIYOU,2018,66,392,379,771
6093,SISKIYOU,2018,67,371,344,715
6093,SISKIYOU,2018,68,358,344,702
6093,SISKIYOU,2018,69,374,348,722
6093,SISKIYOU,2018,70,345,350,695
6093,SISKIYOU,2018,71,367,371,738
6093,SISKIYOU,2018,72,264,271,535
6093,SISKIYOU,2018,73,295,261,556
6093,SISKIYOU,2018,74,284,276,560
6093,SISKIYOU,2018,75,248,276,524
6093,SISKIYOU,2018,76,228,214,442
6093,SISKIYOU,2018,77,179,217,396
6093,SISKIYOU,2018,78,198,194,392
6093,SISKIYOU,2018,79,161,148,309
6093,SISKIYOU,2018,80,147,145,292
6093,SISKIYOU,2018,81,163,163,326
6093,SISKIYOU,2018,82,136,112,248
6093,SISKIYOU,2018,83,138,123,261
6093,SISKIYOU,2018,84,118,86,204
6093,SISKIYOU,2018,85,123,87,210
6093,SISKIYOU,2018,86,102,67,169
6093,SISKIYOU,2018,87,100,69,169
6093,SISKIYOU,2018,88,72,51,123
6093,SISKIYOU,2018,89,96,68,164
6093,SISKIYOU,2018,90,65,50,115
6093,SISKIYOU,2018,91,70,28,98
6093,SISKIYOU,2018,92,54,21,75
6093,SISKIYOU,2018,93,46,25,71
6093,SISKIYOU,2018,94,25,13,38
6093,SISKIYOU,2018,95,23,11,34
6093,SISKIYOU,2018,96,22,3,25
6093,SISKIYOU,2018,97,12,8,20
6093,SISKIYOU,2018,98,7,1,8
6093,SISKIYOU,2018,99,5,0,5
6093,SISKIYOU,2018,100,10,1,11
6093,SISKIYOU,2019,0,225,232,457
6093,SISKIYOU,2019,1,208,255,463
6093,SISKIYOU,2019,2,213,241,454
6093,SISKIYOU,2019,3,205,237,442
6093,SISKIYOU,2019,4,207,231,438
6093,SISKIYOU,2019,5,233,230,463
6093,SISKIYOU,2019,6,242,225,467
6093,SISKIYOU,2019,7,248,247,495
6093,SISKIYOU,2019,8,235,230,465
6093,SISKIYOU,2019,9,225,205,430
6093,SISKIYOU,2019,10,231,272,503
6093,SISKIYOU,2019,11,219,273,492
6093,SISKIYOU,2019,12,257,294,551
6093,SISKIYOU,2019,13,219,238,457
6093,SISKIYOU,2019,14,247,244,491
6093,SISKIYOU,2019,15,263,254,517
6093,SISKIYOU,2019,16,213,248,461
6093,SISKIYOU,2019,17,246,253,499
6093,SISKIYOU,2019,18,242,248,490
6093,SISKIYOU,2019,19,294,303,597
6093,SISKIYOU,2019,20,274,275,549
6093,SISKIYOU,2019,21,271,286,557
6093,SISKIYOU,2019,22,261,289,550
6093,SISKIYOU,2019,23,269,319,588
6093,SISKIYOU,2019,24,238,288,526
6093,SISKIYOU,2019,25,242,323,565
6093,SISKIYOU,2019,26,273,327,600
6093,SISKIYOU,2019,27,264,305,569
6093,SISKIYOU,2019,28,212,265,477
6093,SISKIYOU,2019,29,237,262,499
6093,SISKIYOU,2019,30,197,222,419
6093,SISKIYOU,2019,31,201,217,418
6093,SISKIYOU,2019,32,219,218,437
6093,SISKIYOU,2019,33,198,228,426
6093,SISKIYOU,2019,34,218,252,470
6093,SISKIYOU,2019,35,230,232,462
6093,SISKIYOU,2019,36,221,230,451
6093,SISKIYOU,2019,37,231,214,445
6093,SISKIYOU,2019,38,209,231,440
6093,SISKIYOU,2019,39,227,241,468
6093,SISKIYOU,2019,40,186,211,397
6093,SISKIYOU,2019,41,192,195,387
6093,SISKIYOU,2019,42,178,203,381
6093,SISKIYOU,2019,43,182,195,377
6093,SISKIYOU,2019,44,210,204,414
6093,SISKIYOU,2019,45,197,197,394
6093,SISKIYOU,2019,46,175,192,367
6093,SISKIYOU,2019,47,197,231,428
6093,SISKIYOU,2019,48,235,235,470
6093,SISKIYOU,2019,49,259,224,483
6093,SISKIYOU,2019,50,248,260,508
6093,SISKIYOU,2019,51,202,215,417
6093,SISKIYOU,2019,52,234,205,439
6093,SISKIYOU,2019,53,231,233,464
6093,SISKIYOU,2019,54,250,202,452
6093,SISKIYOU,2019,55,281,264,545
6093,SISKIYOU,2019,56,298,290,588
6093,SISKIYOU,2019,57,299,290,589
6093,SISKIYOU,2019,58,364,305,669
6093,SISKIYOU,2019,59,346,280,626
6093,SISKIYOU,2019,60,347,283,630
6093,SISKIYOU,2019,61,395,327,722
6093,SISKIYOU,2019,62,413,346,759
6093,SISKIYOU,2019,63,393,356,749
6093,SISKIYOU,2019,64,382,365,747
6093,SISKIYOU,2019,65,354,322,676
6093,SISKIYOU,2019,66,433,320,753
6093,SISKIYOU,2019,67,383,378,761
6093,SISKIYOU,2019,68,365,334,699
6093,SISKIYOU,2019,69,358,337,695
6093,SISKIYOU,2019,70,368,341,709
6093,SISKIYOU,2019,71,341,336,677
6093,SISKIYOU,2019,72,361,361,722
6093,SISKIYOU,2019,73,252,264,516
6093,SISKIYOU,2019,74,292,251,543
6093,SISKIYOU,2019,75,283,277,560
6093,SISKIYOU,2019,76,240,261,501
6093,SISKIYOU,2019,77,219,206,425
6093,SISKIYOU,2019,78,176,205,381
6093,SISKIYOU,2019,79,189,189,378
6093,SISKIYOU,2019,80,156,145,301
6093,SISKIYOU,2019,81,135,137,272
6093,SISKIYOU,2019,82,155,158,313
6093,SISKIYOU,2019,83,130,104,234
6093,SISKIYOU,2019,84,130,112,242
6093,SISKIYOU,2019,85,121,82,203
6093,SISKIYOU,2019,86,109,83,192
6093,SISKIYOU,2019,87,103,57,160
6093,SISKIYOU,2019,88,82,63,145
6093,SISKIYOU,2019,89,71,45,116
6093,SISKIYOU,2019,90,85,66,151
6093,SISKIYOU,2019,91,58,36,94
6093,SISKIYOU,2019,92,58,23,81
6093,SISKIYOU,2019,93,46,16,62
6093,SISKIYOU,2019,94,37,22,59
6093,SISKIYOU,2019,95,20,12,32
6093,SISKIYOU,2019,96,17,10,27
6093,SISKIYOU,2019,97,15,0,15
6093,SISKIYOU,2019,98,8,5,13
6093,SISKIYOU,2019,99,2,0,2
6093,SISKIYOU,2019,100,10,1,11
6095,SOLANO,2017,0,2387,2712,5099
6095,SOLANO,2017,1,2488,2635,5123
6095,SOLANO,2017,2,2581,2711,5292
6095,SOLANO,2017,3,2617,2739,5356
6095,SOLANO,2017,4,2565,2724,5289
6095,SOLANO,2017,5,2545,2731,5276
6095,SOLANO,2017,6,2660,2727,5387
6095,SOLANO,2017,7,2542,2696,5238
6095,SOLANO,2017,8,2719,2848,5567
6095,SOLANO,2017,9,2643,2927,5570
6095,SOLANO,2017,10,2716,2956,5672
6095,SOLANO,2017,11,2709,2813,5522
6095,SOLANO,2017,12,2722,2987,5709
6095,SOLANO,2017,13,2767,2997,5764
6095,SOLANO,2017,14,2834,3109,5943
6095,SOLANO,2017,15,3104,3144,6248
6095,SOLANO,2017,16,3078,3215,6293
6095,SOLANO,2017,17,3072,3249,6321
6095,SOLANO,2017,18,2994,3276,6270
6095,SOLANO,2017,19,3192,3370,6562
6095,SOLANO,2017,20,2966,3434,6400
6095,SOLANO,2017,21,3050,3485,6535
6095,SOLANO,2017,22,2997,3329,6326
6095,SOLANO,2017,23,3155,3428,6583
6095,SOLANO,2017,24,3210,3496,6706
6095,SOLANO,2017,25,3004,3254,6258
6095,SOLANO,2017,26,2754,3091,5845
6095,SOLANO,2017,27,2633,3094,5727
6095,SOLANO,2017,28,2636,2765,5401
6095,SOLANO,2017,29,2647,2662,5309
6095,SOLANO,2017,30,2528,2800,5328
6095,SOLANO,2017,31,2640,2719,5359
6095,SOLANO,2017,32,2724,2960,5684
6095,SOLANO,2017,33,2796,2928,5724
6095,SOLANO,2017,34,2712,2893,5605
6095,SOLANO,2017,35,2786,2904,5690
6095,SOLANO,2017,36,2691,2882,5573
6095,SOLANO,2017,37,2756,2872,5628
6095,SOLANO,2017,38,2529,2587,5116
6095,SOLANO,2017,39,2575,2632,5207
6095,SOLANO,2017,40,2563,2681,5244
6095,SOLANO,2017,41,2466,2530,4996
6095,SOLANO,2017,42,2475,2567,5042
6095,SOLANO,2017,43,2520,2466,4986
6095,SOLANO,2017,44,2501,2610,5111
6095,SOLANO,2017,45,2722,2675,5397
6095,SOLANO,2017,46,2800,2871,5671
6095,SOLANO,2017,47,2852,2848,5700
6095,SOLANO,2017,48,2725,2754,5479
6095,SOLANO,2017,49,2715,2816,5531
6095,SOLANO,2017,50,2634,2760,5394
6095,SOLANO,2017,51,2909,2812,5721
6095,SOLANO,2017,52,3006,2935,5941
6095,SOLANO,2017,53,3093,3043,6136
6095,SOLANO,2017,54,3106,3014,6120
6095,SOLANO,2017,55,3126,3039,6165
6095,SOLANO,2017,56,3229,3044,6273
6095,SOLANO,2017,57,3244,3002,6246
6095,SOLANO,2017,58,3116,2951,6067
6095,SOLANO,2017,59,3174,2929,6103
6095,SOLANO,2017,60,3098,2915,6013
6095,SOLANO,2017,61,3206,2744,5950
6095,SOLANO,2017,62,3041,2642,5683
6095,SOLANO,2017,63,2831,2599,5430
6095,SOLANO,2017,64,2862,2448,5310
6095,SOLANO,2017,65,2706,2311,5017
6095,SOLANO,2017,66,2509,2162,4671
6095,SOLANO,2017,67,2462,2297,4759
6095,SOLANO,2017,68,2385,2205,4590
6095,SOLANO,2017,69,2324,2110,4434
6095,SOLANO,2017,70,2321,2052,4373
6095,SOLANO,2017,71,1876,1692,3568
6095,SOLANO,2017,72,1700,1483,3183
6095,SOLANO,2017,73,1634,1472,3106
6095,SOLANO,2017,74,1626,1348,2974
6095,SOLANO,2017,75,1487,1211,2698
6095,SOLANO,2017,76,1306,1092,2398
6095,SOLANO,2017,77,1274,1057,2331
6095,SOLANO,2017,78,1203,951,2154
6095,SOLANO,2017,79,1172,901,2073
6095,SOLANO,2017,80,1103,802,1905
6095,SOLANO,2017,81,1053,679,1732
6095,SOLANO,2017,82,915,681,1596
6095,SOLANO,2017,83,860,622,1482
6095,SOLANO,2017,84,869,555,1424
6095,SOLANO,2017,85,728,521,1249
6095,SOLANO,2017,86,669,411,1080
6095,SOLANO,2017,87,625,364,989
6095,SOLANO,2017,88,542,311,853
6095,SOLANO,2017,89,437,224,661
6095,SOLANO,2017,90,484,238,722
6095,SOLANO,2017,91,349,150,499
6095,SOLANO,2017,92,309,104,413
6095,SOLANO,2017,93,238,112,350
6095,SOLANO,2017,94,206,70,276
6095,SOLANO,2017,95,151,37,188
6095,SOLANO,2017,96,88,51,139
6095,SOLANO,2017,97,59,23,82
6095,SOLANO,2017,98,41,19,60
6095,SOLANO,2017,99,17,18,35
6095,SOLANO,2017,100,35,7,42
6095,SOLANO,2018,0,2501,2744,5245
6095,SOLANO,2018,1,2376,2697,5073
6095,SOLANO,2018,2,2531,2655,5186
6095,SOLANO,2018,3,2614,2778,5392
6095,SOLANO,2018,4,2631,2787,5418
6095,SOLANO,2018,5,2597,2760,5357
6095,SOLANO,2018,6,2559,2741,5300
6095,SOLANO,2018,7,2676,2730,5406
6095,SOLANO,2018,8,2551,2710,5261
6095,SOLANO,2018,9,2728,2857,5585
6095,SOLANO,2018,10,2664,2937,5601
6095,SOLANO,2018,11,2800,3059,5859
6095,SOLANO,2018,12,2774,2908,5682
6095,SOLANO,2018,13,2806,3097,5903
6095,SOLANO,2018,14,2797,3093,5890
6095,SOLANO,2018,15,2978,3227,6205
6095,SOLANO,2018,16,3124,3179,6303
6095,SOLANO,2018,17,3097,3268,6365
6095,SOLANO,2018,18,3115,3302,6417
6095,SOLANO,2018,19,3065,3402,6467
6095,SOLANO,2018,20,3224,3550,6774
6095,SOLANO,2018,21,2986,3427,6413
6095,SOLANO,2018,22,3100,3520,6620
6095,SOLANO,2018,23,3035,3354,6389
6095,SOLANO,2018,24,3211,3485,6696
6095,SOLANO,2018,25,3245,3435,6680
6095,SOLANO,2018,26,3006,3260,6266
6095,SOLANO,2018,27,2749,3096,5845
6095,SOLANO,2018,28,2648,3090,5738
6095,SOLANO,2018,29,2654,2751,5405
6095,SOLANO,2018,30,2648,2708,5356
6095,SOLANO,2018,31,2530,2759,5289
6095,SOLANO,2018,32,2647,2732,5379
6095,SOLANO,2018,33,2733,2951,5684
6095,SOLANO,2018,34,2801,2930,5731
6095,SOLANO,2018,35,2721,2913,5634
6095,SOLANO,2018,36,2777,2885,5662
6095,SOLANO,2018,37,2692,2859,5551
6095,SOLANO,2018,38,2756,2904,5660
6095,SOLANO,2018,39,2526,2590,5116
6095,SOLANO,2018,40,2583,2657,5240
6095,SOLANO,2018,41,2556,2662,5218
6095,SOLANO,2018,42,2471,2535,5006
6095,SOLANO,2018,43,2479,2563,5042
6095,SOLANO,2018,44,2519,2476,4995
6095,SOLANO,2018,45,2513,2624,5137
6095,SOLANO,2018,46,2713,2706,5419
6095,SOLANO,2018,47,2819,2868,5687
6095,SOLANO,2018,48,2852,2794,5646
6095,SOLANO,2018,49,2730,2809,5539
6095,SOLANO,2018,50,2721,2771,5492
6095,SOLANO,2018,51,2631,2744,5375
6095,SOLANO,2018,52,2902,2794,5696
6095,SOLANO,2018,53,2994,2916,5910
6095,SOLANO,2018,54,3088,3037,6125
6095,SOLANO,2018,55,3094,2933,6027
6095,SOLANO,2018,56,3137,3029,6166
6095,SOLANO,2018,57,3222,3050,6272
6095,SOLANO,2018,58,3281,2965,6246
6095,SOLANO,2018,59,3132,2983,6115
6095,SOLANO,2018,60,3175,2868,6043
6095,SOLANO,2018,61,3101,2858,5959
6095,SOLANO,2018,62,3204,2712,5916
6095,SOLANO,2018,63,3032,2623,5655
6095,SOLANO,2018,64,2832,2592,5424
6095,SOLANO,2018,65,2850,2431,5281
6095,SOLANO,2018,66,2686,2272,4958
6095,SOLANO,2018,67,2486,2125,4611
6095,SOLANO,2018,68,2438,2285,4723
6095,SOLANO,2018,69,2361,2152,4513
6095,SOLANO,2018,70,2313,2066,4379
6095,SOLANO,2018,71,2303,2037,4340
6095,SOLANO,2018,72,1863,1672,3535
6095,SOLANO,2018,73,1719,1501,3220
6095,SOLANO,2018,74,1637,1473,3110
6095,SOLANO,2018,75,1645,1328,2973
6095,SOLANO,2018,76,1462,1177,2639
6095,SOLANO,2018,77,1284,1063,2347
6095,SOLANO,2018,78,1267,1014,2281
6095,SOLANO,2018,79,1223,926,2149
6095,SOLANO,2018,80,1176,872,2048
6095,SOLANO,2018,81,1067,773,1840
6095,SOLANO,2018,82,1019,666,1685
6095,SOLANO,2018,83,870,615,1485
6095,SOLANO,2018,84,819,592,1411
6095,SOLANO,2018,85,857,537,1394
6095,SOLANO,2018,86,681,455,1136
6095,SOLANO,2018,87,628,382,1010
6095,SOLANO,2018,88,569,339,908
6095,SOLANO,2018,89,482,289,771
6095,SOLANO,2018,90,416,198,614
6095,SOLANO,2018,91,390,192,582
6095,SOLANO,2018,92,309,129,438
6095,SOLANO,2018,93,261,86,347
6095,SOLANO,2018,94,209,92,301
6095,SOLANO,2018,95,169,55,224
6095,SOLANO,2018,96,112,26,138
6095,SOLANO,2018,97,66,37,103
6095,SOLANO,2018,98,42,17,59
6095,SOLANO,2018,99,33,12,45
6095,SOLANO,2018,100,37,19,56
6095,SOLANO,2019,0,2508,2757,5265
6095,SOLANO,2019,1,2489,2730,5219
6095,SOLANO,2019,2,2411,2723,5134
6095,SOLANO,2019,3,2570,2730,5300
6095,SOLANO,2019,4,2626,2825,5451
6095,SOLANO,2019,5,2656,2825,5481
6095,SOLANO,2019,6,2617,2768,5385
6095,SOLANO,2019,7,2572,2749,5321
6095,SOLANO,2019,8,2681,2748,5429
6095,SOLANO,2019,9,2563,2717,5280
6095,SOLANO,2019,10,2746,2869,5615
6095,SOLANO,2019,11,2758,3030,5788
6095,SOLANO,2019,12,2858,3170,6028
6095,SOLANO,2019,13,2861,3016,5877
6095,SOLANO,2019,14,2841,3186,6027
6095,SOLANO,2019,15,2928,3231,6159
6095,SOLANO,2019,16,3000,3256,6256
6095,SOLANO,2019,17,3140,3237,6377
6095,SOLANO,2019,18,3139,3306,6445
6095,SOLANO,2019,19,3191,3441,6632
6095,SOLANO,2019,20,3104,3589,6693
6095,SOLANO,2019,21,3236,3556,6792
6095,SOLANO,2019,22,3040,3458,6498
6095,SOLANO,2019,23,3149,3559,6708
6095,SOLANO,2019,24,3091,3398,6489
6095,SOLANO,2019,25,3258,3426,6684
6095,SOLANO,2019,26,3244,3446,6690
6095,SOLANO,2019,27,3003,3268,6271
6095,SOLANO,2019,28,2758,3094,5852
6095,SOLANO,2019,29,2665,3079,5744
6095,SOLANO,2019,30,2649,2791,5440
6095,SOLANO,2019,31,2657,2671,5328
6095,SOLANO,2019,32,2536,2775,5311
6095,SOLANO,2019,33,2658,2725,5383
6095,SOLANO,2019,34,2736,2951,5687
6095,SOLANO,2019,35,2806,2950,5756
6095,SOLANO,2019,36,2716,2893,5609
6095,SOLANO,2019,37,2777,2864,5641
6095,SOLANO,2019,38,2691,2892,5583
6095,SOLANO,2019,39,2752,2908,5660
6095,SOLANO,2019,40,2535,2615,5150
6095,SOLANO,2019,41,2585,2644,5229
6095,SOLANO,2019,42,2573,2678,5251
6095,SOLANO,2019,43,2476,2529,5005
6095,SOLANO,2019,44,2476,2572,5048
6095,SOLANO,2019,45,2527,2478,5005
6095,SOLANO,2019,46,2511,2659,5170
6095,SOLANO,2019,47,2722,2698,5420
6095,SOLANO,2019,48,2826,2820,5646
6095,SOLANO,2019,49,2856,2840,5696
6095,SOLANO,2019,50,2739,2769,5508
6095,SOLANO,2019,51,2721,2757,5478
6095,SOLANO,2019,52,2624,2725,5349
6095,SOLANO,2019,53,2883,2771,5654
6095,SOLANO,2019,54,2981,2907,5888
6095,SOLANO,2019,55,3076,2954,6030
6095,SOLANO,2019,56,3118,2922,6040
6095,SOLANO,2019,57,3142,3034,6176
6095,SOLANO,2019,58,3258,3026,6284
6095,SOLANO,2019,59,3287,2990,6277
6095,SOLANO,2019,60,3143,2914,6057
6095,SOLANO,2019,61,3175,2809,5984
6095,SOLANO,2019,62,3115,2827,5942
6095,SOLANO,2019,63,3189,2695,5884
6095,SOLANO,2019,64,3028,2610,5638
6095,SOLANO,2019,65,2829,2561,5390
6095,SOLANO,2019,66,2817,2372,5189
6095,SOLANO,2019,67,2645,2236,4881
6095,SOLANO,2019,68,2461,2121,4582
6095,SOLANO,2019,69,2417,2243,4660
6095,SOLANO,2019,70,2339,2121,4460
6095,SOLANO,2019,71,2302,2049,4351
6095,SOLANO,2019,72,2269,2013,4282
6095,SOLANO,2019,73,1884,1681,3565
6095,SOLANO,2019,74,1727,1509,3236
6095,SOLANO,2019,75,1650,1457,3107
6095,SOLANO,2019,76,1613,1294,2907
6095,SOLANO,2019,77,1440,1142,2582
6095,SOLANO,2019,78,1283,1018,2301
6095,SOLANO,2019,79,1272,988,2260
6095,SOLANO,2019,80,1234,901,2135
6095,SOLANO,2019,81,1132,845,1977
6095,SOLANO,2019,82,1043,756,1799
6095,SOLANO,2019,83,971,619,1590
6095,SOLANO,2019,84,848,584,1432
6095,SOLANO,2019,85,811,567,1378
6095,SOLANO,2019,86,802,484,1286
6095,SOLANO,2019,87,626,410,1036
6095,SOLANO,2019,88,567,346,913
6095,SOLANO,2019,89,528,314,842
6095,SOLANO,2019,90,458,259,717
6095,SOLANO,2019,91,371,158,529
6095,SOLANO,2019,92,331,155,486
6095,SOLANO,2019,93,257,106,363
6095,SOLANO,2019,94,223,67,290
6095,SOLANO,2019,95,178,71,249
6095,SOLANO,2019,96,131,35,166
6095,SOLANO,2019,97,88,17,105
6095,SOLANO,2019,98,54,27,81
6095,SOLANO,2019,99,35,9,44
6095,SOLANO,2019,100,51,24,75
6097,SONOMA,2017,0,2419,2703,5122
6097,SONOMA,2017,1,2480,2645,5125
6097,SONOMA,2017,2,2521,2512,5033
6097,SONOMA,2017,3,2472,2477,4949
6097,SONOMA,2017,4,2493,2567,5060
6097,SONOMA,2017,5,2498,2502,5000
6097,SONOMA,2017,6,2585,2645,5230
6097,SONOMA,2017,7,2582,2818,5400
6097,SONOMA,2017,8,2678,2690,5368
6097,SONOMA,2017,9,2595,2794,5389
6097,SONOMA,2017,10,2798,2904,5702
6097,SONOMA,2017,11,2764,2956,5720
6097,SONOMA,2017,12,2781,2925,5706
6097,SONOMA,2017,13,2750,2997,5747
6097,SONOMA,2017,14,2890,2916,5806
6097,SONOMA,2017,15,2808,2976,5784
6097,SONOMA,2017,16,2949,3038,5987
6097,SONOMA,2017,17,2941,3070,6011
6097,SONOMA,2017,18,3855,3677,7532
6097,SONOMA,2017,19,3501,3610,7111
6097,SONOMA,2017,20,3449,3786,7235
6097,SONOMA,2017,21,3421,3558,6979
6097,SONOMA,2017,22,2991,3199,6190
6097,SONOMA,2017,23,2926,3289,6215
6097,SONOMA,2017,24,2928,3204,6132
6097,SONOMA,2017,25,2709,2981,5690
6097,SONOMA,2017,26,2651,3019,5670
6097,SONOMA,2017,27,2633,2883,5516
6097,SONOMA,2017,28,2664,2796,5460
6097,SONOMA,2017,29,2792,2912,5704
6097,SONOMA,2017,30,2734,3156,5890
6097,SONOMA,2017,31,2986,3291,6277
6097,SONOMA,2017,32,3202,3586,6788
6097,SONOMA,2017,33,3277,3650,6927
6097,SONOMA,2017,34,3347,3718,7065
6097,SONOMA,2017,35,3417,3804,7221
6097,SONOMA,2017,36,3433,3513,6946
6097,SONOMA,2017,37,3420,3515,6935
6097,SONOMA,2017,38,3022,3416,6438
6097,SONOMA,2017,39,3032,3130,6162
6097,SONOMA,2017,40,2890,3030,5920
6097,SONOMA,2017,41,2768,2929,5697
6097,SONOMA,2017,42,2712,2884,5596
6097,SONOMA,2017,43,2744,2744,5488
6097,SONOMA,2017,44,2798,2924,5722
6097,SONOMA,2017,45,2980,2996,5976
6097,SONOMA,2017,46,3207,3131,6338
6097,SONOMA,2017,47,3488,3452,6940
6097,SONOMA,2017,48,3167,3240,6407
6097,SONOMA,2017,49,3039,3181,6220
6097,SONOMA,2017,50,3070,3055,6125
6097,SONOMA,2017,51,3151,3169,6320
6097,SONOMA,2017,52,3446,3338,6784
6097,SONOMA,2017,53,3602,3321,6923
6097,SONOMA,2017,54,3722,3471,7193
6097,SONOMA,2017,55,3760,3389,7149
6097,SONOMA,2017,56,3836,3548,7384
6097,SONOMA,2017,57,4074,3771,7845
6097,SONOMA,2017,58,3943,3606,7549
6097,SONOMA,2017,59,4027,3669,7696
6097,SONOMA,2017,60,4056,3565,7621
6097,SONOMA,2017,61,4072,3592,7664
6097,SONOMA,2017,62,3997,3586,7583
6097,SONOMA,2017,63,4028,3489,7517
6097,SONOMA,2017,64,3956,3328,7284
6097,SONOMA,2017,65,3883,3253,7136
6097,SONOMA,2017,66,3612,3202,6814
6097,SONOMA,2017,67,3605,3193,6798
6097,SONOMA,2017,68,3598,3103,6701
6097,SONOMA,2017,69,3548,3109,6657
6097,SONOMA,2017,70,3414,3062,6476
6097,SONOMA,2017,71,2842,2417,5259
6097,SONOMA,2017,72,2766,2320,5086
6097,SONOMA,2017,73,2405,2279,4684
6097,SONOMA,2017,74,2375,2002,4377
6097,SONOMA,2017,75,2109,1824,3933
6097,SONOMA,2017,76,1892,1511,3403
6097,SONOMA,2017,77,1649,1440,3089
6097,SONOMA,2017,78,1497,1249,2746
6097,SONOMA,2017,79,1442,1134,2576
6097,SONOMA,2017,80,1406,1072,2478
6097,SONOMA,2017,81,1267,908,2175
6097,SONOMA,2017,82,1125,839,1964
6097,SONOMA,2017,83,1078,684,1762
6097,SONOMA,2017,84,1026,671,1697
6097,SONOMA,2017,85,1111,668,1779
6097,SONOMA,2017,86,1000,630,1630
6097,SONOMA,2017,87,930,529,1459
6097,SONOMA,2017,88,861,462,1323
6097,SONOMA,2017,89,758,432,1190
6097,SONOMA,2017,90,743,370,1113
6097,SONOMA,2017,91,651,316,967
6097,SONOMA,2017,92,506,248,754
6097,SONOMA,2017,93,420,150,570
6097,SONOMA,2017,94,351,147,498
6097,SONOMA,2017,95,293,110,403
6097,SONOMA,2017,96,230,70,300
6097,SONOMA,2017,97,122,26,148
6097,SONOMA,2017,98,70,24,94
6097,SONOMA,2017,99,41,11,52
6097,SONOMA,2017,100,54,15,69
6097,SONOMA,2018,0,2373,2711,5084
6097,SONOMA,2018,1,2403,2687,5090
6097,SONOMA,2018,2,2476,2646,5122
6097,SONOMA,2018,3,2519,2510,5029
6097,SONOMA,2018,4,2464,2469,4933
6097,SONOMA,2018,5,2482,2564,5046
6097,SONOMA,2018,6,2493,2496,4989
6097,SONOMA,2018,7,2578,2640,5218
6097,SONOMA,2018,8,2577,2811,5388
6097,SONOMA,2018,9,2670,2685,5355
6097,SONOMA,2018,10,2593,2800,5393
6097,SONOMA,2018,11,2806,2910,5716
6097,SONOMA,2018,12,2758,2958,5716
6097,SONOMA,2018,13,2778,2920,5698
6097,SONOMA,2018,14,2752,3000,5752
6097,SONOMA,2018,15,2913,2911,5824
6097,SONOMA,2018,16,2893,3062,5955
6097,SONOMA,2018,17,2969,3041,6010
6097,SONOMA,2018,18,3769,3735,7504
6097,SONOMA,2018,19,3563,3536,7099
6097,SONOMA,2018,20,3408,3667,7075
6097,SONOMA,2018,21,3294,3692,6986
6097,SONOMA,2018,22,3281,3275,6556
6097,SONOMA,2018,23,2951,3124,6075
6097,SONOMA,2018,24,2813,3191,6004
6097,SONOMA,2018,25,2762,3103,5865
6097,SONOMA,2018,26,2719,2954,5673
6097,SONOMA,2018,27,2665,3049,5714
6097,SONOMA,2018,28,2687,2930,5617
6097,SONOMA,2018,29,2734,2846,5580
6097,SONOMA,2018,30,2833,2965,5798
6097,SONOMA,2018,31,2789,3200,5989
6097,SONOMA,2018,32,3042,3353,6395
6097,SONOMA,2018,33,3296,3656,6952
6097,SONOMA,2018,34,3321,3720,7041
6097,SONOMA,2018,35,3376,3792,7168
6097,SONOMA,2018,36,3390,3763,7153
6097,SONOMA,2018,37,3434,3505,6939
6097,SONOMA,2018,38,3402,3510,6912
6097,SONOMA,2018,39,3027,3407,6434
6097,SONOMA,2018,40,3018,3138,6156
6097,SONOMA,2018,41,2921,3045,5966
6097,SONOMA,2018,42,2821,2929,5750
6097,SONOMA,2018,43,2719,2901,5620
6097,SONOMA,2018,44,2766,2794,5560
6097,SONOMA,2018,45,2840,2936,5776
6097,SONOMA,2018,46,2958,2985,5943
6097,SONOMA,2018,47,3205,3144,6349
6097,SONOMA,2018,48,3469,3421,6890
6097,SONOMA,2018,49,3171,3236,6407
6097,SONOMA,2018,50,3028,3166,6194
6097,SONOMA,2018,51,3087,3075,6162
6097,SONOMA,2018,52,3169,3188,6357
6097,SONOMA,2018,53,3453,3330,6783
6097,SONOMA,2018,54,3606,3327,6933
6097,SONOMA,2018,55,3737,3454,7191
6097,SONOMA,2018,56,3764,3430,7194
6097,SONOMA,2018,57,3895,3557,7452
6097,SONOMA,2018,58,4107,3755,7862
6097,SONOMA,2018,59,3994,3608,7602
6097,SONOMA,2018,60,4060,3679,7739
6097,SONOMA,2018,61,4054,3538,7592
6097,SONOMA,2018,62,4045,3562,7607
6097,SONOMA,2018,63,3981,3589,7570
6097,SONOMA,2018,64,4013,3462,7475
6097,SONOMA,2018,65,3949,3289,7238
6097,SONOMA,2018,66,3889,3236,7125
6097,SONOMA,2018,67,3627,3228,6855
6097,SONOMA,2018,68,3583,3149,6732
6097,SONOMA,2018,69,3602,3085,6687
6097,SONOMA,2018,70,3581,3090,6671
6097,SONOMA,2018,71,3394,3011,6405
6097,SONOMA,2018,72,2849,2406,5255
6097,SONOMA,2018,73,2724,2292,5016
6097,SONOMA,2018,74,2379,2264,4643
6097,SONOMA,2018,75,2405,1963,4368
6097,SONOMA,2018,76,2064,1774,3838
6097,SONOMA,2018,77,1840,1474,3314
6097,SONOMA,2018,78,1600,1390,2990
6097,SONOMA,2018,79,1490,1224,2714
6097,SONOMA,2018,80,1446,1106,2552
6097,SONOMA,2018,81,1371,1014,2385
6097,SONOMA,2018,82,1193,880,2073
6097,SONOMA,2018,83,1094,793,1887
6097,SONOMA,2018,84,1008,627,1635
6097,SONOMA,2018,85,1057,672,1729
6097,SONOMA,2018,86,1066,606,1672
6097,SONOMA,2018,87,922,585,1507
6097,SONOMA,2018,88,882,494,1376
6097,SONOMA,2018,89,773,429,1202
6097,SONOMA,2018,90,728,416,1144
6097,SONOMA,2018,91,632,298,930
6097,SONOMA,2018,92,541,239,780
6097,SONOMA,2018,93,416,191,607
6097,SONOMA,2018,94,360,109,469
6097,SONOMA,2018,95,303,112,415
6097,SONOMA,2018,96,205,80,285
6097,SONOMA,2018,97,172,45,217
6097,SONOMA,2018,98,93,21,114
6097,SONOMA,2018,99,37,16,53
6097,SONOMA,2018,100,57,13,70
6097,SONOMA,2019,0,2414,2672,5086
6097,SONOMA,2019,1,2362,2690,5052
6097,SONOMA,2019,2,2403,2689,5092
6097,SONOMA,2019,3,2482,2646,5128
6097,SONOMA,2019,4,2510,2502,5012
6097,SONOMA,2019,5,2458,2469,4927
6097,SONOMA,2019,6,2477,2561,5038
6097,SONOMA,2019,7,2489,2489,4978
6097,SONOMA,2019,8,2573,2631,5204
6097,SONOMA,2019,9,2572,2807,5379
6097,SONOMA,2019,10,2669,2691,5360
6097,SONOMA,2019,11,2601,2808,5409
6097,SONOMA,2019,12,2799,2910,5709
6097,SONOMA,2019,13,2754,2953,5707
6097,SONOMA,2019,14,2783,2922,5705
6097,SONOMA,2019,15,2774,2997,5771
6097,SONOMA,2019,16,2999,2995,5994
6097,SONOMA,2019,17,2928,3077,6005
6097,SONOMA,2019,18,3795,3709,7504
6097,SONOMA,2019,19,3472,3602,7074
6097,SONOMA,2019,20,3467,3598,7065
6097,SONOMA,2019,21,3250,3580,6830
6097,SONOMA,2019,22,3158,3419,6577
6097,SONOMA,2019,23,3244,3208,6452
6097,SONOMA,2019,24,2833,3034,5867
6097,SONOMA,2019,25,2655,3086,5741
6097,SONOMA,2019,26,2763,3071,5834
6097,SONOMA,2019,27,2744,2984,5728
6097,SONOMA,2019,28,2719,3115,5834
6097,SONOMA,2019,29,2751,3005,5756
6097,SONOMA,2019,30,2762,2903,5665
6097,SONOMA,2019,31,2886,3018,5904
6097,SONOMA,2019,32,2840,3274,6114
6097,SONOMA,2019,33,3147,3425,6572
6097,SONOMA,2019,34,3338,3721,7059
6097,SONOMA,2019,35,3378,3811,7189
6097,SONOMA,2019,36,3350,3753,7103
6097,SONOMA,2019,37,3391,3754,7145
6097,SONOMA,2019,38,3421,3500,6921
6097,SONOMA,2019,39,3405,3507,6912
6097,SONOMA,2019,40,3011,3414,6425
6097,SONOMA,2019,41,3053,3153,6206
6097,SONOMA,2019,42,2972,3042,6014
6097,SONOMA,2019,43,2828,2943,5771
6097,SONOMA,2019,44,2744,2958,5702
6097,SONOMA,2019,45,2814,2817,5631
6097,SONOMA,2019,46,2822,2929,5751
6097,SONOMA,2019,47,2958,2994,5952
6097,SONOMA,2019,48,3188,3121,6309
6097,SONOMA,2019,49,3464,3417,6881
6097,SONOMA,2019,50,3160,3227,6387
6097,SONOMA,2019,51,3046,3173,6219
6097,SONOMA,2019,52,3114,3100,6214
6097,SONOMA,2019,53,3167,3188,6355
6097,SONOMA,2019,54,3473,3341,6814
6097,SONOMA,2019,55,3616,3315,6931
6097,SONOMA,2019,56,3733,3506,7239
6097,SONOMA,2019,57,3822,3440,7262
6097,SONOMA,2019,58,3937,3545,7482
6097,SONOMA,2019,59,4163,3755,7918
6097,SONOMA,2019,60,4025,3609,7634
6097,SONOMA,2019,61,4057,3676,7733
6097,SONOMA,2019,62,4024,3500,7524
6097,SONOMA,2019,63,4040,3560,7600
6097,SONOMA,2019,64,3957,3564,7521
6097,SONOMA,2019,65,4002,3431,7433
6097,SONOMA,2019,66,3968,3261,7229
6097,SONOMA,2019,67,3915,3250,7165
6097,SONOMA,2019,68,3611,3200,6811
6097,SONOMA,2019,69,3579,3136,6715
6097,SONOMA,2019,70,3632,3097,6729
6097,SONOMA,2019,71,3552,3059,6611
6097,SONOMA,2019,72,3392,3012,6404
6097,SONOMA,2019,73,2805,2380,5185
6097,SONOMA,2019,74,2687,2269,4956
6097,SONOMA,2019,75,2396,2220,4616
6097,SONOMA,2019,76,2356,1900,4256
6097,SONOMA,2019,77,2029,1741,3770
6097,SONOMA,2019,78,1798,1427,3225
6097,SONOMA,2019,79,1609,1374,2983
6097,SONOMA,2019,80,1498,1197,2695
6097,SONOMA,2019,81,1407,1031,2438
6097,SONOMA,2019,82,1287,964,2251
6097,SONOMA,2019,83,1151,831,1982
6097,SONOMA,2019,84,1034,729,1763
6097,SONOMA,2019,85,1041,617,1658
6097,SONOMA,2019,86,998,615,1613
6097,SONOMA,2019,87,976,566,1542
6097,SONOMA,2019,88,887,546,1433
6097,SONOMA,2019,89,798,454,1252
6097,SONOMA,2019,90,729,388,1117
6097,SONOMA,2019,91,632,319,951
6097,SONOMA,2019,92,528,235,763
6097,SONOMA,2019,93,432,183,615
6097,SONOMA,2019,94,352,151,503
6097,SONOMA,2019,95,303,81,384
6097,SONOMA,2019,96,221,64,285
6097,SONOMA,2019,97,157,52,209
6097,SONOMA,2019,98,138,33,171
6097,SONOMA,2019,99,64,14,78
6097,SONOMA,2019,100,60,20,80
6099,STANISLAUS,2017,0,3742,3936,7678
6099,STANISLAUS,2017,1,3704,3994,7698
6099,STANISLAUS,2017,2,3762,3933,7695
6099,STANISLAUS,2017,3,3700,3917,7617
6099,STANISLAUS,2017,4,3788,3907,7695
6099,STANISLAUS,2017,5,3926,4046,7972
6099,STANISLAUS,2017,6,3907,4191,8098
6099,STANISLAUS,2017,7,3891,4155,8046
6099,STANISLAUS,2017,8,3988,4230,8218
6099,STANISLAUS,2017,9,4202,4360,8562
6099,STANISLAUS,2017,10,4208,4406,8614
6099,STANISLAUS,2017,11,4125,4397,8522
6099,STANISLAUS,2017,12,4081,4252,8333
6099,STANISLAUS,2017,13,4016,4043,8059
6099,STANISLAUS,2017,14,3962,4248,8210
6099,STANISLAUS,2017,15,3987,4138,8125
6099,STANISLAUS,2017,16,3943,4150,8093
6099,STANISLAUS,2017,17,4040,4334,8374
6099,STANISLAUS,2017,18,4388,4758,9146
6099,STANISLAUS,2017,19,4882,4965,9847
6099,STANISLAUS,2017,20,4763,5278,10041
6099,STANISLAUS,2017,21,4645,5156,9801
6099,STANISLAUS,2017,22,4675,4949,9624
6099,STANISLAUS,2017,23,4517,5025,9542
6099,STANISLAUS,2017,24,4493,4861,9354
6099,STANISLAUS,2017,25,4186,4262,8448
6099,STANISLAUS,2017,26,3599,3593,7192
6099,STANISLAUS,2017,27,3254,3512,6766
6099,STANISLAUS,2017,28,3268,3261,6529
6099,STANISLAUS,2017,29,3289,3345,6634
6099,STANISLAUS,2017,30,3232,3289,6521
6099,STANISLAUS,2017,31,3354,3324,6678
6099,STANISLAUS,2017,32,3537,3587,7124
6099,STANISLAUS,2017,33,3753,3736,7489
6099,STANISLAUS,2017,34,3736,3859,7595
6099,STANISLAUS,2017,35,3663,3689,7352
6099,STANISLAUS,2017,36,3571,3650,7221
6099,STANISLAUS,2017,37,3603,3574,7177
6099,STANISLAUS,2017,38,3463,3458,6921
6099,STANISLAUS,2017,39,3328,3396,6724
6099,STANISLAUS,2017,40,3331,3355,6686
6099,STANISLAUS,2017,41,3253,3227,6480
6099,STANISLAUS,2017,42,3216,3236,6452
6099,STANISLAUS,2017,43,3201,3149,6350
6099,STANISLAUS,2017,44,3230,3074,6304
6099,STANISLAUS,2017,45,3255,3240,6495
6099,STANISLAUS,2017,46,3431,3302,6733
6099,STANISLAUS,2017,47,3443,3480,6923
6099,STANISLAUS,2017,48,3480,3316,6796
6099,STANISLAUS,2017,49,3431,3206,6637
6099,STANISLAUS,2017,50,3254,3187,6441
6099,STANISLAUS,2017,51,3181,3181,6362
6099,STANISLAUS,2017,52,3444,3337,6781
6099,STANISLAUS,2017,53,3470,3381,6851
6099,STANISLAUS,2017,54,3559,3314,6873
6099,STANISLAUS,2017,55,3499,3377,6876
6099,STANISLAUS,2017,56,3509,3466,6975
6099,STANISLAUS,2017,57,3459,3422,6881
6099,STANISLAUS,2017,58,3336,3034,6370
6099,STANISLAUS,2017,59,3162,3090,6252
6099,STANISLAUS,2017,60,3191,2992,6183
6099,STANISLAUS,2017,61,3185,2919,6104
6099,STANISLAUS,2017,62,3077,2822,5899
6099,STANISLAUS,2017,63,2835,2694,5529
6099,STANISLAUS,2017,64,2871,2638,5509
6099,STANISLAUS,2017,65,2705,2395,5100
6099,STANISLAUS,2017,66,2596,2294,4890
6099,STANISLAUS,2017,67,2494,2300,4794
6099,STANISLAUS,2017,68,2427,2071,4498
6099,STANISLAUS,2017,69,2406,2096,4502
6099,STANISLAUS,2017,70,2327,1991,4318
6099,STANISLAUS,2017,71,1957,1698,3655
6099,STANISLAUS,2017,72,1855,1570,3425
6099,STANISLAUS,2017,73,1694,1525,3219
6099,STANISLAUS,2017,74,1663,1376,3039
6099,STANISLAUS,2017,75,1617,1166,2783
6099,STANISLAUS,2017,76,1403,1014,2417
6099,STANISLAUS,2017,77,1252,991,2243
6099,STANISLAUS,2017,78,1253,985,2238
6099,STANISLAUS,2017,79,1183,922,2105
6099,STANISLAUS,2017,80,1190,828,2018
6099,STANISLAUS,2017,81,1126,788,1914
6099,STANISLAUS,2017,82,1016,637,1653
6099,STANISLAUS,2017,83,912,621,1533
6099,STANISLAUS,2017,84,845,564,1409
6099,STANISLAUS,2017,85,814,502,1316
6099,STANISLAUS,2017,86,737,448,1185
6099,STANISLAUS,2017,87,723,429,1152
6099,STANISLAUS,2017,88,594,385,979
6099,STANISLAUS,2017,89,595,305,900
6099,STANISLAUS,2017,90,549,247,796
6099,STANISLAUS,2017,91,497,204,701
6099,STANISLAUS,2017,92,331,194,525
6099,STANISLAUS,2017,93,257,139,396
6099,STANISLAUS,2017,94,182,99,281
6099,STANISLAUS,2017,95,170,78,248
6099,STANISLAUS,2017,96,141,52,193
6099,STANISLAUS,2017,97,91,11,102
6099,STANISLAUS,2017,98,37,11,48
6099,STANISLAUS,2017,99,24,4,28
6099,STANISLAUS,2017,100,22,10,32
6099,STANISLAUS,2018,0,3721,4141,7862
6099,STANISLAUS,2018,1,3723,3911,7634
6099,STANISLAUS,2018,2,3747,4041,7788
6099,STANISLAUS,2018,3,3829,3965,7794
6099,STANISLAUS,2018,4,3743,3962,7705
6099,STANISLAUS,2018,5,3795,3980,7775
6099,STANISLAUS,2018,6,3974,4129,8103
6099,STANISLAUS,2018,7,3973,4232,8205
6099,STANISLAUS,2018,8,3958,4223,8181
6099,STANISLAUS,2018,9,4061,4307,8368
6099,STANISLAUS,2018,10,4240,4418,8658
6099,STANISLAUS,2018,11,4214,4409,8623
6099,STANISLAUS,2018,12,4127,4391,8518
6099,STANISLAUS,2018,13,4077,4245,8322
6099,STANISLAUS,2018,14,4014,4051,8065
6099,STANISLAUS,2018,15,3984,4247,8231
6099,STANISLAUS,2018,16,4013,4215,8228
6099,STANISLAUS,2018,17,4081,4279,8360
6099,STANISLAUS,2018,18,4384,4706,9090
6099,STANISLAUS,2018,19,4839,5123,9962
6099,STANISLAUS,2018,20,4802,4978,9780
6099,STANISLAUS,2018,21,4598,5098,9696
6099,STANISLAUS,2018,22,4662,5111,9773
6099,STANISLAUS,2018,23,4650,4940,9590
6099,STANISLAUS,2018,24,4490,4973,9463
6099,STANISLAUS,2018,25,4495,4831,9326
6099,STANISLAUS,2018,26,3994,4063,8057
6099,STANISLAUS,2018,27,3608,3637,7245
6099,STANISLAUS,2018,28,3288,3510,6798
6099,STANISLAUS,2018,29,3296,3298,6594
6099,STANISLAUS,2018,30,3264,3290,6554
6099,STANISLAUS,2018,31,3294,3347,6641
6099,STANISLAUS,2018,32,3390,3368,6758
6099,STANISLAUS,2018,33,3591,3643,7234
6099,STANISLAUS,2018,34,3753,3780,7533
6099,STANISLAUS,2018,35,3750,3878,7628
6099,STANISLAUS,2018,36,3654,3688,7342
6099,STANISLAUS,2018,37,3581,3655,7236
6099,STANISLAUS,2018,38,3619,3574,7193
6099,STANISLAUS,2018,39,3465,3451,6916
6099,STANISLAUS,2018,40,3332,3413,6745
6099,STANISLAUS,2018,41,3332,3324,6656
6099,STANISLAUS,2018,42,3245,3224,6469
6099,STANISLAUS,2018,43,3228,3236,6464
6099,STANISLAUS,2018,44,3178,3144,6322
6099,STANISLAUS,2018,45,3238,3057,6295
6099,STANISLAUS,2018,46,3267,3246,6513
6099,STANISLAUS,2018,47,3431,3313,6744
6099,STANISLAUS,2018,48,3437,3482,6919
6099,STANISLAUS,2018,49,3482,3311,6793
6099,STANISLAUS,2018,50,3432,3203,6635
6099,STANISLAUS,2018,51,3246,3153,6399
6099,STANISLAUS,2018,52,3171,3170,6341
6099,STANISLAUS,2018,53,3420,3338,6758
6099,STANISLAUS,2018,54,3469,3351,6820
6099,STANISLAUS,2018,55,3537,3265,6802
6099,STANISLAUS,2018,56,3466,3350,6816
6099,STANISLAUS,2018,57,3488,3426,6914
6099,STANISLAUS,2018,58,3446,3387,6833
6099,STANISLAUS,2018,59,3306,2980,6286
6099,STANISLAUS,2018,60,3125,3061,6186
6099,STANISLAUS,2018,61,3166,2950,6116
6099,STANISLAUS,2018,62,3149,2886,6035
6099,STANISLAUS,2018,63,3067,2788,5855
6099,STANISLAUS,2018,64,2806,2652,5458
6099,STANISLAUS,2018,65,2877,2608,5485
6099,STANISLAUS,2018,66,2675,2358,5033
6099,STANISLAUS,2018,67,2560,2256,4816
6099,STANISLAUS,2018,68,2464,2236,4700
6099,STANISLAUS,2018,69,2402,2047,4449
6099,STANISLAUS,2018,70,2394,2046,4440
6099,STANISLAUS,2018,71,2265,1948,4213
6099,STANISLAUS,2018,72,1923,1636,3559
6099,STANISLAUS,2018,73,1805,1525,3330
6099,STANISLAUS,2018,74,1670,1494,3164
6099,STANISLAUS,2018,75,1641,1346,2987
6099,STANISLAUS,2018,76,1585,1099,2684
6099,STANISLAUS,2018,77,1370,980,2350
6099,STANISLAUS,2018,78,1221,957,2178
6099,STANISLAUS,2018,79,1218,940,2158
6099,STANISLAUS,2018,80,1205,891,2096
6099,STANISLAUS,2018,81,1126,784,1910
6099,STANISLAUS,2018,82,1057,712,1769
6099,STANISLAUS,2018,83,990,583,1573
6099,STANISLAUS,2018,84,881,590,1471
6099,STANISLAUS,2018,85,829,539,1368
6099,STANISLAUS,2018,86,740,449,1189
6099,STANISLAUS,2018,87,691,405,1096
6099,STANISLAUS,2018,88,707,385,1092
6099,STANISLAUS,2018,89,528,327,855
6099,STANISLAUS,2018,90,530,278,808
6099,STANISLAUS,2018,91,485,181,666
6099,STANISLAUS,2018,92,408,168,576
6099,STANISLAUS,2018,93,278,162,440
6099,STANISLAUS,2018,94,224,105,329
6099,STANISLAUS,2018,95,157,78,235
6099,STANISLAUS,2018,96,131,55,186
6099,STANISLAUS,2018,97,124,40,164
6099,STANISLAUS,2018,98,55,5,60
6099,STANISLAUS,2018,99,30,11,41
6099,STANISLAUS,2018,100,27,8,35
6099,STANISLAUS,2019,0,3760,4122,7882
6099,STANISLAUS,2019,1,3699,4120,7819
6099,STANISLAUS,2019,2,3770,3973,7743
6099,STANISLAUS,2019,3,3803,4080,7883
6099,STANISLAUS,2019,4,3870,3994,7864
6099,STANISLAUS,2019,5,3757,4038,7795
6099,STANISLAUS,2019,6,3853,4065,7918
6099,STANISLAUS,2019,7,4041,4205,8246
6099,STANISLAUS,2019,8,4030,4283,8313
6099,STANISLAUS,2019,9,4012,4289,8301
6099,STANISLAUS,2019,10,4107,4365,8472
6099,STANISLAUS,2019,11,4243,4421,8664
6099,STANISLAUS,2019,12,4218,4403,8621
6099,STANISLAUS,2019,13,4123,4385,8508
6099,STANISLAUS,2019,14,4075,4250,8325
6099,STANISLAUS,2019,15,4039,4055,8094
6099,STANISLAUS,2019,16,4009,4320,8329
6099,STANISLAUS,2019,17,4155,4345,8500
6099,STANISLAUS,2019,18,4417,4657,9074
6099,STANISLAUS,2019,19,4830,5078,9908
6099,STANISLAUS,2019,20,4757,5132,9889
6099,STANISLAUS,2019,21,4632,4807,9439
6099,STANISLAUS,2019,22,4599,5053,9652
6099,STANISLAUS,2019,23,4635,5098,9733
6099,STANISLAUS,2019,24,4619,4900,9519
6099,STANISLAUS,2019,25,4500,4942,9442
6099,STANISLAUS,2019,26,4301,4635,8936
6099,STANISLAUS,2019,27,4000,4108,8108
6099,STANISLAUS,2019,28,3639,3628,7267
6099,STANISLAUS,2019,29,3315,3543,6858
6099,STANISLAUS,2019,30,3271,3246,6517
6099,STANISLAUS,2019,31,3319,3330,6649
6099,STANISLAUS,2019,32,3340,3380,6720
6099,STANISLAUS,2019,33,3449,3421,6870
6099,STANISLAUS,2019,34,3594,3701,7295
6099,STANISLAUS,2019,35,3768,3799,7567
6099,STANISLAUS,2019,36,3742,3882,7624
6099,STANISLAUS,2019,37,3664,3691,7355
6099,STANISLAUS,2019,38,3592,3660,7252
6099,STANISLAUS,2019,39,3614,3568,7182
6099,STANISLAUS,2019,40,3469,3478,6947
6099,STANISLAUS,2019,41,3330,3388,6718
6099,STANISLAUS,2019,42,3319,3329,6648
6099,STANISLAUS,2019,43,3262,3223,6485
6099,STANISLAUS,2019,44,3214,3234,6448
6099,STANISLAUS,2019,45,3185,3126,6311
6099,STANISLAUS,2019,46,3239,3053,6292
6099,STANISLAUS,2019,47,3271,3268,6539
6099,STANISLAUS,2019,48,3425,3310,6735
6099,STANISLAUS,2019,49,3438,3478,6916
6099,STANISLAUS,2019,50,3480,3313,6793
6099,STANISLAUS,2019,51,3424,3173,6597
6099,STANISLAUS,2019,52,3237,3145,6382
6099,STANISLAUS,2019,53,3137,3172,6309
6099,STANISLAUS,2019,54,3420,3316,6736
6099,STANISLAUS,2019,55,3443,3295,6738
6099,STANISLAUS,2019,56,3502,3235,6737
6099,STANISLAUS,2019,57,3455,3312,6767
6099,STANISLAUS,2019,58,3464,3400,6864
6099,STANISLAUS,2019,59,3413,3335,6748
6099,STANISLAUS,2019,60,3279,2950,6229
6099,STANISLAUS,2019,61,3100,3026,6126
6099,STANISLAUS,2019,62,3156,2923,6079
6099,STANISLAUS,2019,63,3141,2848,5989
6099,STANISLAUS,2019,64,3042,2738,5780
6099,STANISLAUS,2019,65,2816,2594,5410
6099,STANISLAUS,2019,66,2859,2572,5431
6099,STANISLAUS,2019,67,2643,2316,4959
6099,STANISLAUS,2019,68,2530,2211,4741
6099,STANISLAUS,2019,69,2433,2210,4643
6099,STANISLAUS,2019,70,2391,2005,4396
6099,STANISLAUS,2019,71,2342,2006,4348
6099,STANISLAUS,2019,72,2237,1878,4115
6099,STANISLAUS,2019,73,1873,1596,3469
6099,STANISLAUS,2019,74,1772,1477,3249
6099,STANISLAUS,2019,75,1663,1463,3126
6099,STANISLAUS,2019,76,1604,1292,2896
6099,STANISLAUS,2019,77,1546,1073,2619
6099,STANISLAUS,2019,78,1317,950,2267
6099,STANISLAUS,2019,79,1180,914,2094
6099,STANISLAUS,2019,80,1234,924,2158
6099,STANISLAUS,2019,81,1144,834,1978
6099,STANISLAUS,2019,82,1057,724,1781
6099,STANISLAUS,2019,83,1027,659,1686
6099,STANISLAUS,2019,84,936,545,1481
6099,STANISLAUS,2019,85,865,569,1434
6099,STANISLAUS,2019,86,753,499,1252
6099,STANISLAUS,2019,87,701,394,1095
6099,STANISLAUS,2019,88,676,360,1036
6099,STANISLAUS,2019,89,640,348,988
6099,STANISLAUS,2019,90,476,294,770
6099,STANISLAUS,2019,91,477,230,707
6099,STANISLAUS,2019,92,404,144,548
6099,STANISLAUS,2019,93,353,133,486
6099,STANISLAUS,2019,94,242,121,363
6099,STANISLAUS,2019,95,184,80,264
6099,STANISLAUS,2019,96,117,48,165
6099,STANISLAUS,2019,97,101,40,141
6099,STANISLAUS,2019,98,87,27,114
6099,STANISLAUS,2019,99,39,5,44
6099,STANISLAUS,2019,100,40,11,51
6101,SUTTER,2017,0,644,740,1384
6101,SUTTER,2017,1,659,724,1383
6101,SUTTER,2017,2,643,649,1292
6101,SUTTER,2017,3,594,707,1301
6101,SUTTER,2017,4,617,615,1232
6101,SUTTER,2017,5,678,644,1322
6101,SUTTER,2017,6,632,701,1333
6101,SUTTER,2017,7,669,686,1355
6101,SUTTER,2017,8,691,690,1381
6101,SUTTER,2017,9,666,749,1415
6101,SUTTER,2017,10,761,760,1521
6101,SUTTER,2017,11,717,733,1450
6101,SUTTER,2017,12,686,781,1467
6101,SUTTER,2017,13,721,745,1466
6101,SUTTER,2017,14,694,756,1450
6101,SUTTER,2017,15,713,708,1421
6101,SUTTER,2017,16,716,773,1489
6101,SUTTER,2017,17,697,724,1421
6101,SUTTER,2017,18,762,728,1490
6101,SUTTER,2017,19,682,696,1378
6101,SUTTER,2017,20,720,722,1442
6101,SUTTER,2017,21,702,788,1490
6101,SUTTER,2017,22,665,781,1446
6101,SUTTER,2017,23,716,758,1474
6101,SUTTER,2017,24,791,842,1633
6101,SUTTER,2017,25,684,776,1460
6101,SUTTER,2017,26,643,760,1403
6101,SUTTER,2017,27,636,709,1345
6101,SUTTER,2017,28,571,629,1200
6101,SUTTER,2017,29,630,665,1295
6101,SUTTER,2017,30,625,671,1296
6101,SUTTER,2017,31,582,663,1245
6101,SUTTER,2017,32,658,679,1337
6101,SUTTER,2017,33,627,637,1264
6101,SUTTER,2017,34,675,646,1321
6101,SUTTER,2017,35,631,615,1246
6101,SUTTER,2017,36,653,607,1260
6101,SUTTER,2017,37,616,664,1280
6101,SUTTER,2017,38,592,606,1198
6101,SUTTER,2017,39,570,601,1171
6101,SUTTER,2017,40,586,636,1222
6101,SUTTER,2017,41,647,568,1215
6101,SUTTER,2017,42,528,561,1089
6101,SUTTER,2017,43,551,527,1078
6101,SUTTER,2017,44,570,573,1143
6101,SUTTER,2017,45,601,581,1182
6101,SUTTER,2017,46,588,626,1214
6101,SUTTER,2017,47,615,646,1261
6101,SUTTER,2017,48,589,558,1147
6101,SUTTER,2017,49,576,567,1143
6101,SUTTER,2017,50,623,571,1194
6101,SUTTER,2017,51,650,583,1233
6101,SUTTER,2017,52,649,665,1314
6101,SUTTER,2017,53,643,671,1314
6101,SUTTER,2017,54,605,652,1257
6101,SUTTER,2017,55,671,615,1286
6101,SUTTER,2017,56,675,605,1280
6101,SUTTER,2017,57,635,620,1255
6101,SUTTER,2017,58,613,570,1183
6101,SUTTER,2017,59,592,587,1179
6101,SUTTER,2017,60,561,551,1112
6101,SUTTER,2017,61,577,529,1106
6101,SUTTER,2017,62,610,542,1152
6101,SUTTER,2017,63,566,549,1115
6101,SUTTER,2017,64,523,475,998
6101,SUTTER,2017,65,470,433,903
6101,SUTTER,2017,66,490,465,955
6101,SUTTER,2017,67,474,429,903
6101,SUTTER,2017,68,490,454,944
6101,SUTTER,2017,69,477,443,920
6101,SUTTER,2017,70,418,404,822
6101,SUTTER,2017,71,402,321,723
6101,SUTTER,2017,72,378,293,671
6101,SUTTER,2017,73,355,293,648
6101,SUTTER,2017,74,386,297,683
6101,SUTTER,2017,75,343,278,621
6101,SUTTER,2017,76,267,248,515
6101,SUTTER,2017,77,297,225,522
6101,SUTTER,2017,78,266,226,492
6101,SUTTER,2017,79,250,191,441
6101,SUTTER,2017,80,249,185,434
6101,SUTTER,2017,81,242,201,443
6101,SUTTER,2017,82,206,172,378
6101,SUTTER,2017,83,208,154,362
6101,SUTTER,2017,84,169,144,313
6101,SUTTER,2017,85,158,135,293
6101,SUTTER,2017,86,171,134,305
6101,SUTTER,2017,87,151,95,246
6101,SUTTER,2017,88,119,69,188
6101,SUTTER,2017,89,110,78,188
6101,SUTTER,2017,90,102,60,162
6101,SUTTER,2017,91,108,51,159
6101,SUTTER,2017,92,49,28,77
6101,SUTTER,2017,93,40,23,63
6101,SUTTER,2017,94,44,20,64
6101,SUTTER,2017,95,30,7,37
6101,SUTTER,2017,96,32,12,44
6101,SUTTER,2017,97,9,1,10
6101,SUTTER,2017,98,7,6,13
6101,SUTTER,2017,99,6,4,10
6101,SUTTER,2017,100,8,3,11
6101,SUTTER,2018,0,643,749,1392
6101,SUTTER,2018,1,642,736,1378
6101,SUTTER,2018,2,661,725,1386
6101,SUTTER,2018,3,646,651,1297
6101,SUTTER,2018,4,594,707,1301
6101,SUTTER,2018,5,617,615,1232
6101,SUTTER,2018,6,677,644,1321
6101,SUTTER,2018,7,632,701,1333
6101,SUTTER,2018,8,669,686,1355
6101,SUTTER,2018,9,691,691,1382
6101,SUTTER,2018,10,666,749,1415
6101,SUTTER,2018,11,761,761,1522
6101,SUTTER,2018,12,718,735,1453
6101,SUTTER,2018,13,686,781,1467
6101,SUTTER,2018,14,722,749,1471
6101,SUTTER,2018,15,696,757,1453
6101,SUTTER,2018,16,723,717,1440
6101,SUTTER,2018,17,712,767,1479
6101,SUTTER,2018,18,697,722,1419
6101,SUTTER,2018,19,764,732,1496
6101,SUTTER,2018,20,687,698,1385
6101,SUTTER,2018,21,722,729,1451
6101,SUTTER,2018,22,712,791,1503
6101,SUTTER,2018,23,668,787,1455
6101,SUTTER,2018,24,721,765,1486
6101,SUTTER,2018,25,803,841,1644
6101,SUTTER,2018,26,688,783,1471
6101,SUTTER,2018,27,649,764,1413
6101,SUTTER,2018,28,639,716,1355
6101,SUTTER,2018,29,568,635,1203
6101,SUTTER,2018,30,638,662,1300
6101,SUTTER,2018,31,627,670,1297
6101,SUTTER,2018,32,575,666,1241
6101,SUTTER,2018,33,663,675,1338
6101,SUTTER,2018,34,625,644,1269
6101,SUTTER,2018,35,674,641,1315
6101,SUTTER,2018,36,629,613,1242
6101,SUTTER,2018,37,660,608,1268
6101,SUTTER,2018,38,615,664,1279
6101,SUTTER,2018,39,587,607,1194
6101,SUTTER,2018,40,562,601,1163
6101,SUTTER,2018,41,601,633,1234
6101,SUTTER,2018,42,632,568,1200
6101,SUTTER,2018,43,531,563,1094
6101,SUTTER,2018,44,547,526,1073
6101,SUTTER,2018,45,569,564,1133
6101,SUTTER,2018,46,604,579,1183
6101,SUTTER,2018,47,590,624,1214
6101,SUTTER,2018,48,616,653,1269
6101,SUTTER,2018,49,587,549,1136
6101,SUTTER,2018,50,576,568,1144
6101,SUTTER,2018,51,635,579,1214
6101,SUTTER,2018,52,651,589,1240
6101,SUTTER,2018,53,653,668,1321
6101,SUTTER,2018,54,661,671,1332
6101,SUTTER,2018,55,600,659,1259
6101,SUTTER,2018,56,662,614,1276
6101,SUTTER,2018,57,669,590,1259
6101,SUTTER,2018,58,624,616,1240
6101,SUTTER,2018,59,604,564,1168
6101,SUTTER,2018,60,588,585,1173
6101,SUTTER,2018,61,561,545,1106
6101,SUTTER,2018,62,571,522,1093
6101,SUTTER,2018,63,607,530,1137
6101,SUTTER,2018,64,558,541,1099
6101,SUTTER,2018,65,521,468,989
6101,SUTTER,2018,66,467,426,893
6101,SUTTER,2018,67,482,460,942
6101,SUTTER,2018,68,469,420,889
6101,SUTTER,2018,69,480,448,928
6101,SUTTER,2018,70,475,428,903
6101,SUTTER,2018,71,412,395,807
6101,SUTTER,2018,72,387,311,698
6101,SUTTER,2018,73,377,282,659
6101,SUTTER,2018,74,352,286,638
6101,SUTTER,2018,75,380,282,662
6101,SUTTER,2018,76,329,270,599
6101,SUTTER,2018,77,258,233,491
6101,SUTTER,2018,78,284,217,501
6101,SUTTER,2018,79,259,212,471
6101,SUTTER,2018,80,238,184,422
6101,SUTTER,2018,81,242,175,417
6101,SUTTER,2018,82,231,187,418
6101,SUTTER,2018,83,195,168,363
6101,SUTTER,2018,84,189,137,326
6101,SUTTER,2018,85,173,135,308
6101,SUTTER,2018,86,152,117,269
6101,SUTTER,2018,87,157,120,277
6101,SUTTER,2018,88,138,89,227
6101,SUTTER,2018,89,111,62,173
6101,SUTTER,2018,90,103,68,171
6101,SUTTER,2018,91,85,46,131
6101,SUTTER,2018,92,87,36,123
6101,SUTTER,2018,93,43,22,65
6101,SUTTER,2018,94,28,18,46
6101,SUTTER,2018,95,34,10,44
6101,SUTTER,2018,96,22,6,28
6101,SUTTER,2018,97,22,9,31
6101,SUTTER,2018,98,6,0,6
6101,SUTTER,2018,99,7,5,12
6101,SUTTER,2018,100,9,3,12
6101,SUTTER,2019,0,684,714,1398
6101,SUTTER,2019,1,641,743,1384
6101,SUTTER,2019,2,642,736,1378
6101,SUTTER,2019,3,663,730,1393
6101,SUTTER,2019,4,646,651,1297
6101,SUTTER,2019,5,594,710,1304
6101,SUTTER,2019,6,616,615,1231
6101,SUTTER,2019,7,677,644,1321
6101,SUTTER,2019,8,632,701,1333
6101,SUTTER,2019,9,669,687,1356
6101,SUTTER,2019,10,691,692,1383
6101,SUTTER,2019,11,667,750,1417
6101,SUTTER,2019,12,762,762,1524
6101,SUTTER,2019,13,718,738,1456
6101,SUTTER,2019,14,688,782,1470
6101,SUTTER,2019,15,724,753,1477
6101,SUTTER,2019,16,706,770,1476
6101,SUTTER,2019,17,717,706,1423
6101,SUTTER,2019,18,713,767,1480
6101,SUTTER,2019,19,701,727,1428
6101,SUTTER,2019,20,769,732,1501
6101,SUTTER,2019,21,695,710,1405
6101,SUTTER,2019,22,731,736,1467
6101,SUTTER,2019,23,718,799,1517
6101,SUTTER,2019,24,666,794,1460
6101,SUTTER,2019,25,736,764,1500
6101,SUTTER,2019,26,804,853,1657
6101,SUTTER,2019,27,695,787,1482
6101,SUTTER,2019,28,653,773,1426
6101,SUTTER,2019,29,638,721,1359
6101,SUTTER,2019,30,577,632,1209
6101,SUTTER,2019,31,638,659,1297
6101,SUTTER,2019,32,622,675,1297
6101,SUTTER,2019,33,582,660,1242
6101,SUTTER,2019,34,660,683,1343
6101,SUTTER,2019,35,625,639,1264
6101,SUTTER,2019,36,672,638,1310
6101,SUTTER,2019,37,636,614,1250
6101,SUTTER,2019,38,659,607,1266
6101,SUTTER,2019,39,613,664,1277
6101,SUTTER,2019,40,579,608,1187
6101,SUTTER,2019,41,578,598,1176
6101,SUTTER,2019,42,588,633,1221
6101,SUTTER,2019,43,635,569,1204
6101,SUTTER,2019,44,531,562,1093
6101,SUTTER,2019,45,545,520,1065
6101,SUTTER,2019,46,571,563,1134
6101,SUTTER,2019,47,605,580,1185
6101,SUTTER,2019,48,591,627,1218
6101,SUTTER,2019,49,619,646,1265
6101,SUTTER,2019,50,589,552,1141
6101,SUTTER,2019,51,592,574,1166
6101,SUTTER,2019,52,641,587,1228
6101,SUTTER,2019,53,658,595,1253
6101,SUTTER,2019,54,676,671,1347
6101,SUTTER,2019,55,661,677,1338
6101,SUTTER,2019,56,594,657,1251
6101,SUTTER,2019,57,649,602,1251
6101,SUTTER,2019,58,661,588,1249
6101,SUTTER,2019,59,619,609,1228
6101,SUTTER,2019,60,603,560,1163
6101,SUTTER,2019,61,582,577,1159
6101,SUTTER,2019,62,557,537,1094
6101,SUTTER,2019,63,564,510,1074
6101,SUTTER,2019,64,597,520,1117
6101,SUTTER,2019,65,552,535,1087
6101,SUTTER,2019,66,516,454,970
6101,SUTTER,2019,67,456,418,874
6101,SUTTER,2019,68,474,444,918
6101,SUTTER,2019,69,463,412,875
6101,SUTTER,2019,70,472,436,908
6101,SUTTER,2019,71,471,411,882
6101,SUTTER,2019,72,402,387,789
6101,SUTTER,2019,73,382,294,676
6101,SUTTER,2019,74,368,280,648
6101,SUTTER,2019,75,349,274,623
6101,SUTTER,2019,76,366,277,643
6101,SUTTER,2019,77,328,255,583
6101,SUTTER,2019,78,254,224,478
6101,SUTTER,2019,79,283,212,495
6101,SUTTER,2019,80,254,205,459
6101,SUTTER,2019,81,226,173,399
6101,SUTTER,2019,82,231,163,394
6101,SUTTER,2019,83,221,186,407
6101,SUTTER,2019,84,171,156,327
6101,SUTTER,2019,85,191,132,323
6101,SUTTER,2019,86,162,124,286
6101,SUTTER,2019,87,141,105,246
6101,SUTTER,2019,88,139,110,249
6101,SUTTER,2019,89,131,79,210
6101,SUTTER,2019,90,99,53,152
6101,SUTTER,2019,91,90,56,146
6101,SUTTER,2019,92,70,36,106
6101,SUTTER,2019,93,73,29,102
6101,SUTTER,2019,94,37,15,52
6101,SUTTER,2019,95,23,14,37
6101,SUTTER,2019,96,27,9,36
6101,SUTTER,2019,97,21,5,26
6101,SUTTER,2019,98,17,4,21
6101,SUTTER,2019,99,5,0,5
6101,SUTTER,2019,100,9,5,14
6103,TEHAMA,2017,0,411,416,827
6103,TEHAMA,2017,1,414,412,826
6103,TEHAMA,2017,2,434,448,882
6103,TEHAMA,2017,3,461,484,945
6103,TEHAMA,2017,4,435,410,845
6103,TEHAMA,2017,5,418,453,871
6103,TEHAMA,2017,6,382,397,779
6103,TEHAMA,2017,7,412,421,833
6103,TEHAMA,2017,8,376,419,795
6103,TEHAMA,2017,9,421,451,872
6103,TEHAMA,2017,10,436,441,877
6103,TEHAMA,2017,11,445,439,884
6103,TEHAMA,2017,12,427,460,887
6103,TEHAMA,2017,13,444,465,909
6103,TEHAMA,2017,14,408,464,872
6103,TEHAMA,2017,15,397,442,839
6103,TEHAMA,2017,16,444,432,876
6103,TEHAMA,2017,17,402,405,807
6103,TEHAMA,2017,18,415,430,845
6103,TEHAMA,2017,19,400,449,849
6103,TEHAMA,2017,20,423,417,840
6103,TEHAMA,2017,21,446,474,920
6103,TEHAMA,2017,22,463,455,918
6103,TEHAMA,2017,23,463,527,990
6103,TEHAMA,2017,24,464,533,997
6103,TEHAMA,2017,25,414,466,880
6103,TEHAMA,2017,26,393,436,829
6103,TEHAMA,2017,27,399,461,860
6103,TEHAMA,2017,28,384,393,777
6103,TEHAMA,2017,29,362,356,718
6103,TEHAMA,2017,30,379,400,779
6103,TEHAMA,2017,31,380,371,751
6103,TEHAMA,2017,32,351,329,680
6103,TEHAMA,2017,33,291,394,685
6103,TEHAMA,2017,34,306,374,680
6103,TEHAMA,2017,35,371,357,728
6103,TEHAMA,2017,36,351,365,716
6103,TEHAMA,2017,37,366,348,714
6103,TEHAMA,2017,38,322,362,684
6103,TEHAMA,2017,39,344,331,675
6103,TEHAMA,2017,40,306,356,662
6103,TEHAMA,2017,41,290,306,596
6103,TEHAMA,2017,42,303,341,644
6103,TEHAMA,2017,43,347,360,707
6103,TEHAMA,2017,44,303,323,626
6103,TEHAMA,2017,45,364,316,680
6103,TEHAMA,2017,46,369,362,731
6103,TEHAMA,2017,47,387,388,775
6103,TEHAMA,2017,48,367,357,724
6103,TEHAMA,2017,49,356,351,707
6103,TEHAMA,2017,50,367,353,720
6103,TEHAMA,2017,51,350,390,740
6103,TEHAMA,2017,52,425,365,790
6103,TEHAMA,2017,53,465,448,913
6103,TEHAMA,2017,54,430,409,839
6103,TEHAMA,2017,55,476,425,901
6103,TEHAMA,2017,56,458,456,914
6103,TEHAMA,2017,57,477,467,944
6103,TEHAMA,2017,58,433,437,870
6103,TEHAMA,2017,59,436,373,809
6103,TEHAMA,2017,60,437,440,877
6103,TEHAMA,2017,61,406,372,778
6103,TEHAMA,2017,62,448,402,850
6103,TEHAMA,2017,63,407,337,744
6103,TEHAMA,2017,64,406,335,741
6103,TEHAMA,2017,65,411,323,734
6103,TEHAMA,2017,66,377,380,757
6103,TEHAMA,2017,67,385,368,753
6103,TEHAMA,2017,68,386,332,718
6103,TEHAMA,2017,69,376,370,746
6103,TEHAMA,2017,70,401,356,757
6103,TEHAMA,2017,71,314,315,629
6103,TEHAMA,2017,72,302,297,599
6103,TEHAMA,2017,73,312,228,540
6103,TEHAMA,2017,74,283,253,536
6103,TEHAMA,2017,75,289,222,511
6103,TEHAMA,2017,76,281,255,536
6103,TEHAMA,2017,77,253,200,453
6103,TEHAMA,2017,78,194,213,407
6103,TEHAMA,2017,79,207,173,380
6103,TEHAMA,2017,80,216,160,376
6103,TEHAMA,2017,81,195,137,332
6103,TEHAMA,2017,82,194,139,333
6103,TEHAMA,2017,83,150,114,264
6103,TEHAMA,2017,84,126,114,240
6103,TEHAMA,2017,85,142,109,251
6103,TEHAMA,2017,86,129,105,234
6103,TEHAMA,2017,87,139,70,209
6103,TEHAMA,2017,88,79,65,144
6103,TEHAMA,2017,89,61,50,111
6103,TEHAMA,2017,90,79,36,115
6103,TEHAMA,2017,91,68,30,98
6103,TEHAMA,2017,92,43,45,88
6103,TEHAMA,2017,93,42,14,56
6103,TEHAMA,2017,94,42,33,75
6103,TEHAMA,2017,95,24,12,36
6103,TEHAMA,2017,96,16,11,27
6103,TEHAMA,2017,97,12,2,14
6103,TEHAMA,2017,98,6,4,10
6103,TEHAMA,2017,99,9,4,13
6103,TEHAMA,2017,100,7,1,8
6103,TEHAMA,2018,0,425,415,840
6103,TEHAMA,2018,1,410,411,821
6103,TEHAMA,2018,2,427,418,845
6103,TEHAMA,2018,3,444,453,897
6103,TEHAMA,2018,4,470,486,956
6103,TEHAMA,2018,5,436,415,851
6103,TEHAMA,2018,6,416,448,864
6103,TEHAMA,2018,7,379,397,776
6103,TEHAMA,2018,8,409,418,827
6103,TEHAMA,2018,9,372,413,785
6103,TEHAMA,2018,10,421,450,871
6103,TEHAMA,2018,11,445,450,895
6103,TEHAMA,2018,12,444,443,887
6103,TEHAMA,2018,13,428,468,896
6103,TEHAMA,2018,14,451,470,921
6103,TEHAMA,2018,15,409,470,879
6103,TEHAMA,2018,16,393,437,830
6103,TEHAMA,2018,17,440,428,868
6103,TEHAMA,2018,18,396,392,788
6103,TEHAMA,2018,19,414,432,846
6103,TEHAMA,2018,20,379,448,827
6103,TEHAMA,2018,21,421,407,828
6103,TEHAMA,2018,22,436,469,905
6103,TEHAMA,2018,23,463,454,917
6103,TEHAMA,2018,24,460,521,981
6103,TEHAMA,2018,25,458,527,985
6103,TEHAMA,2018,26,429,487,916
6103,TEHAMA,2018,27,421,462,883
6103,TEHAMA,2018,28,405,468,873
6103,TEHAMA,2018,29,397,405,802
6103,TEHAMA,2018,30,375,375,750
6103,TEHAMA,2018,31,376,398,774
6103,TEHAMA,2018,32,380,364,744
6103,TEHAMA,2018,33,352,324,676
6103,TEHAMA,2018,34,287,392,679
6103,TEHAMA,2018,35,309,378,687
6103,TEHAMA,2018,36,371,360,731
6103,TEHAMA,2018,37,345,350,695
6103,TEHAMA,2018,38,364,350,714
6103,TEHAMA,2018,39,318,357,675
6103,TEHAMA,2018,40,344,316,660
6103,TEHAMA,2018,41,299,357,656
6103,TEHAMA,2018,42,293,300,593
6103,TEHAMA,2018,43,295,347,642
6103,TEHAMA,2018,44,344,357,701
6103,TEHAMA,2018,45,303,306,609
6103,TEHAMA,2018,46,368,324,692
6103,TEHAMA,2018,47,373,369,742
6103,TEHAMA,2018,48,391,393,784
6103,TEHAMA,2018,49,372,350,722
6103,TEHAMA,2018,50,356,353,709
6103,TEHAMA,2018,51,363,357,720
6103,TEHAMA,2018,52,348,382,730
6103,TEHAMA,2018,53,430,370,800
6103,TEHAMA,2018,54,457,435,892
6103,TEHAMA,2018,55,429,404,833
6103,TEHAMA,2018,56,474,424,898
6103,TEHAMA,2018,57,454,450,904
6103,TEHAMA,2018,58,472,460,932
6103,TEHAMA,2018,59,433,436,869
6103,TEHAMA,2018,60,425,368,793
6103,TEHAMA,2018,61,426,432,858
6103,TEHAMA,2018,62,408,365,773
6103,TEHAMA,2018,63,440,397,837
6103,TEHAMA,2018,64,405,332,737
6103,TEHAMA,2018,65,401,329,730
6103,TEHAMA,2018,66,409,318,727
6103,TEHAMA,2018,67,367,373,740
6103,TEHAMA,2018,68,376,359,735
6103,TEHAMA,2018,69,384,322,706
6103,TEHAMA,2018,70,373,362,735
6103,TEHAMA,2018,71,393,345,738
6103,TEHAMA,2018,72,301,305,606
6103,TEHAMA,2018,73,298,292,590
6103,TEHAMA,2018,74,305,213,518
6103,TEHAMA,2018,75,276,247,523
6103,TEHAMA,2018,76,280,211,491
6103,TEHAMA,2018,77,266,247,513
6103,TEHAMA,2018,78,244,192,436
6103,TEHAMA,2018,79,188,206,394
6103,TEHAMA,2018,80,208,165,373
6103,TEHAMA,2018,81,196,147,343
6103,TEHAMA,2018,82,176,124,300
6103,TEHAMA,2018,83,184,129,313
6103,TEHAMA,2018,84,135,104,239
6103,TEHAMA,2018,85,134,105,239
6103,TEHAMA,2018,86,126,104,230
6103,TEHAMA,2018,87,117,95,212
6103,TEHAMA,2018,88,119,62,181
6103,TEHAMA,2018,89,72,55,127
6103,TEHAMA,2018,90,57,46,103
6103,TEHAMA,2018,91,67,30,97
6103,TEHAMA,2018,92,57,20,77
6103,TEHAMA,2018,93,34,35,69
6103,TEHAMA,2018,94,37,14,51
6103,TEHAMA,2018,95,35,25,60
6103,TEHAMA,2018,96,16,8,24
6103,TEHAMA,2018,97,14,8,22
6103,TEHAMA,2018,98,9,2,11
6103,TEHAMA,2018,99,4,1,5
6103,TEHAMA,2018,100,12,4,16
6103,TEHAMA,2019,0,412,455,867
6103,TEHAMA,2019,1,423,414,837
6103,TEHAMA,2019,2,427,414,841
6103,TEHAMA,2019,3,436,426,862
6103,TEHAMA,2019,4,446,460,906
6103,TEHAMA,2019,5,472,491,963
6103,TEHAMA,2019,6,431,409,840
6103,TEHAMA,2019,7,413,449,862
6103,TEHAMA,2019,8,377,394,771
6103,TEHAMA,2019,9,408,416,824
6103,TEHAMA,2019,10,370,410,780
6103,TEHAMA,2019,11,426,464,890
6103,TEHAMA,2019,12,444,455,899
6103,TEHAMA,2019,13,445,454,899
6103,TEHAMA,2019,14,432,470,902
6103,TEHAMA,2019,15,453,478,931
6103,TEHAMA,2019,16,400,462,862
6103,TEHAMA,2019,17,387,425,812
6103,TEHAMA,2019,18,436,424,860
6103,TEHAMA,2019,19,398,402,800
6103,TEHAMA,2019,20,398,424,822
6103,TEHAMA,2019,21,375,436,811
6103,TEHAMA,2019,22,416,399,815
6103,TEHAMA,2019,23,433,470,903
6103,TEHAMA,2019,24,459,454,913
6103,TEHAMA,2019,25,455,515,970
6103,TEHAMA,2019,26,474,547,1021
6103,TEHAMA,2019,27,446,521,967
6103,TEHAMA,2019,28,432,477,909
6103,TEHAMA,2019,29,415,482,897
6103,TEHAMA,2019,30,418,414,832
6103,TEHAMA,2019,31,374,377,751
6103,TEHAMA,2019,32,374,389,763
6103,TEHAMA,2019,33,378,362,740
6103,TEHAMA,2019,34,347,321,668
6103,TEHAMA,2019,35,290,394,684
6103,TEHAMA,2019,36,312,381,693
6103,TEHAMA,2019,37,365,349,714
6103,TEHAMA,2019,38,342,350,692
6103,TEHAMA,2019,39,362,345,707
6103,TEHAMA,2019,40,313,342,655
6103,TEHAMA,2019,41,340,318,658
6103,TEHAMA,2019,42,304,353,657
6103,TEHAMA,2019,43,288,305,593
6103,TEHAMA,2019,44,292,343,635
6103,TEHAMA,2019,45,341,341,682
6103,TEHAMA,2019,46,311,311,622
6103,TEHAMA,2019,47,371,337,708
6103,TEHAMA,2019,48,376,373,749
6103,TEHAMA,2019,49,394,385,779
6103,TEHAMA,2019,50,370,351,721
6103,TEHAMA,2019,51,354,352,706
6103,TEHAMA,2019,52,361,349,710
6103,TEHAMA,2019,53,350,386,736
6103,TEHAMA,2019,54,421,359,780
6103,TEHAMA,2019,55,455,430,885
6103,TEHAMA,2019,56,425,405,830
6103,TEHAMA,2019,57,467,420,887
6103,TEHAMA,2019,58,449,442,891
6103,TEHAMA,2019,59,469,461,930
6103,TEHAMA,2019,60,430,434,864
6103,TEHAMA,2019,61,423,366,789
6103,TEHAMA,2019,62,424,426,850
6103,TEHAMA,2019,63,404,356,760
6103,TEHAMA,2019,64,437,392,829
6103,TEHAMA,2019,65,401,322,723
6103,TEHAMA,2019,66,396,323,719
6103,TEHAMA,2019,67,403,317,720
6103,TEHAMA,2019,68,363,361,724
6103,TEHAMA,2019,69,373,352,725
6103,TEHAMA,2019,70,375,313,688
6103,TEHAMA,2019,71,366,345,711
6103,TEHAMA,2019,72,380,337,717
6103,TEHAMA,2019,73,291,298,589
6103,TEHAMA,2019,74,294,280,574
6103,TEHAMA,2019,75,302,210,512
6103,TEHAMA,2019,76,266,226,492
6103,TEHAMA,2019,77,268,203,471
6103,TEHAMA,2019,78,260,230,490
6103,TEHAMA,2019,79,237,179,416
6103,TEHAMA,2019,80,189,195,384
6103,TEHAMA,2019,81,191,156,347
6103,TEHAMA,2019,82,179,134,313
6103,TEHAMA,2019,83,167,119,286
6103,TEHAMA,2019,84,175,116,291
6103,TEHAMA,2019,85,136,96,232
6103,TEHAMA,2019,86,121,91,212
6103,TEHAMA,2019,87,116,94,210
6103,TEHAMA,2019,88,100,83,183
6103,TEHAMA,2019,89,112,53,165
6103,TEHAMA,2019,90,65,47,112
6103,TEHAMA,2019,91,45,43,88
6103,TEHAMA,2019,92,57,26,83
6103,TEHAMA,2019,93,49,13,62
6103,TEHAMA,2019,94,28,30,58
6103,TEHAMA,2019,95,36,9,45
6103,TEHAMA,2019,96,22,20,42
6103,TEHAMA,2019,97,11,7,18
6103,TEHAMA,2019,98,11,5,16
6103,TEHAMA,2019,99,5,2,7
6103,TEHAMA,2019,100,10,2,12
6105,TRINITY,2017,0,54,50,104
6105,TRINITY,2017,1,49,54,103
6105,TRINITY,2017,2,47,60,107
6105,TRINITY,2017,3,50,61,111
6105,TRINITY,2017,4,57,57,114
6105,TRINITY,2017,5,56,53,109
6105,TRINITY,2017,6,52,54,106
6105,TRINITY,2017,7,68,42,110
6105,TRINITY,2017,8,54,57,111
6105,TRINITY,2017,9,50,59,109
6105,TRINITY,2017,10,53,77,130
6105,TRINITY,2017,11,63,77,140
6105,TRINITY,2017,12,70,79,149
6105,TRINITY,2017,13,51,82,133
6105,TRINITY,2017,14,61,61,122
6105,TRINITY,2017,15,69,72,141
6105,TRINITY,2017,16,61,65,126
6105,TRINITY,2017,17,59,63,122
6105,TRINITY,2017,18,82,58,140
6105,TRINITY,2017,19,76,68,144
6105,TRINITY,2017,20,88,79,167
6105,TRINITY,2017,21,86,89,175
6105,TRINITY,2017,22,87,87,174
6105,TRINITY,2017,23,80,83,163
6105,TRINITY,2017,24,103,95,198
6105,TRINITY,2017,25,61,86,147
6105,TRINITY,2017,26,57,63,120
6105,TRINITY,2017,27,61,80,141
6105,TRINITY,2017,28,53,54,107
6105,TRINITY,2017,29,46,62,108
6105,TRINITY,2017,30,54,65,119
6105,TRINITY,2017,31,50,59,109
6105,TRINITY,2017,32,50,75,125
6105,TRINITY,2017,33,47,55,102
6105,TRINITY,2017,34,52,59,111
6105,TRINITY,2017,35,61,76,137
6105,TRINITY,2017,36,55,57,112
6105,TRINITY,2017,37,62,70,132
6105,TRINITY,2017,38,52,70,122
6105,TRINITY,2017,39,70,76,146
6105,TRINITY,2017,40,50,50,100
6105,TRINITY,2017,41,66,63,129
6105,TRINITY,2017,42,52,77,129
6105,TRINITY,2017,43,76,64,140
6105,TRINITY,2017,44,54,55,109
6105,TRINITY,2017,45,52,75,127
6105,TRINITY,2017,46,67,75,142
6105,TRINITY,2017,47,67,69,136
6105,TRINITY,2017,48,65,72,137
6105,TRINITY,2017,49,70,55,125
6105,TRINITY,2017,50,73,88,161
6105,TRINITY,2017,51,68,68,136
6105,TRINITY,2017,52,88,78,166
6105,TRINITY,2017,53,100,106,206
6105,TRINITY,2017,54,112,99,211
6105,TRINITY,2017,55,104,102,206
6105,TRINITY,2017,56,118,99,217
6105,TRINITY,2017,57,115,124,239
6105,TRINITY,2017,58,115,95,210
6105,TRINITY,2017,59,114,97,211
6105,TRINITY,2017,60,149,124,273
6105,TRINITY,2017,61,121,115,236
6105,TRINITY,2017,62,113,106,219
6105,TRINITY,2017,63,140,149,289
6105,TRINITY,2017,64,127,144,271
6105,TRINITY,2017,65,129,120,249
6105,TRINITY,2017,66,127,126,253
6105,TRINITY,2017,67,132,120,252
6105,TRINITY,2017,68,114,122,236
6105,TRINITY,2017,69,132,134,266
6105,TRINITY,2017,70,118,126,244
6105,TRINITY,2017,71,80,98,178
6105,TRINITY,2017,72,82,104,186
6105,TRINITY,2017,73,91,121,212
6105,TRINITY,2017,74,77,84,161
6105,TRINITY,2017,75,80,100,180
6105,TRINITY,2017,76,87,70,157
6105,TRINITY,2017,77,57,66,123
6105,TRINITY,2017,78,71,72,143
6105,TRINITY,2017,79,40,53,93
6105,TRINITY,2017,80,52,58,110
6105,TRINITY,2017,81,36,53,89
6105,TRINITY,2017,82,41,44,85
6105,TRINITY,2017,83,47,45,92
6105,TRINITY,2017,84,52,31,83
6105,TRINITY,2017,85,41,24,65
6105,TRINITY,2017,86,39,27,66
6105,TRINITY,2017,87,20,38,58
6105,TRINITY,2017,88,26,16,42
6105,TRINITY,2017,89,18,14,32
6105,TRINITY,2017,90,17,17,34
6105,TRINITY,2017,91,13,18,31
6105,TRINITY,2017,92,9,5,14
6105,TRINITY,2017,93,5,6,11
6105,TRINITY,2017,94,4,1,5
6105,TRINITY,2017,95,7,0,7
6105,TRINITY,2017,96,1,6,7
6105,TRINITY,2017,97,2,1,3
6105,TRINITY,2017,98,2,1,3
6105,TRINITY,2017,99,1,0,1
6105,TRINITY,2017,100,4,1,5
6105,TRINITY,2018,0,42,61,103
6105,TRINITY,2018,1,53,50,103
6105,TRINITY,2018,2,50,58,108
6105,TRINITY,2018,3,51,60,111
6105,TRINITY,2018,4,51,67,118
6105,TRINITY,2018,5,57,55,112
6105,TRINITY,2018,6,54,54,108
6105,TRINITY,2018,7,52,53,105
6105,TRINITY,2018,8,69,41,110
6105,TRINITY,2018,9,53,55,108
6105,TRINITY,2018,10,50,59,109
6105,TRINITY,2018,11,56,79,135
6105,TRINITY,2018,12,63,77,140
6105,TRINITY,2018,13,73,84,157
6105,TRINITY,2018,14,53,81,134
6105,TRINITY,2018,15,62,62,124
6105,TRINITY,2018,16,66,73,139
6105,TRINITY,2018,17,62,65,127
6105,TRINITY,2018,18,58,58,116
6105,TRINITY,2018,19,87,63,150
6105,TRINITY,2018,20,70,71,141
6105,TRINITY,2018,21,88,73,161
6105,TRINITY,2018,22,86,86,172
6105,TRINITY,2018,23,85,90,175
6105,TRINITY,2018,24,82,84,166
6105,TRINITY,2018,25,103,91,194
6105,TRINITY,2018,26,60,86,146
6105,TRINITY,2018,27,58,73,131
6105,TRINITY,2018,28,65,79,144
6105,TRINITY,2018,29,54,56,110
6105,TRINITY,2018,30,50,64,114
6105,TRINITY,2018,31,50,64,114
6105,TRINITY,2018,32,51,56,107
6105,TRINITY,2018,33,49,72,121
6105,TRINITY,2018,34,45,57,102
6105,TRINITY,2018,35,56,58,114
6105,TRINITY,2018,36,60,75,135
6105,TRINITY,2018,37,52,58,110
6105,TRINITY,2018,38,63,70,133
6105,TRINITY,2018,39,53,73,126
6105,TRINITY,2018,40,70,77,147
6105,TRINITY,2018,41,50,45,95
6105,TRINITY,2018,42,62,60,122
6105,TRINITY,2018,43,56,79,135
6105,TRINITY,2018,44,75,65,140
6105,TRINITY,2018,45,54,48,102
6105,TRINITY,2018,46,51,79,130
6105,TRINITY,2018,47,67,79,146
6105,TRINITY,2018,48,67,62,129
6105,TRINITY,2018,49,64,73,137
6105,TRINITY,2018,50,70,56,126
6105,TRINITY,2018,51,70,92,162
6105,TRINITY,2018,52,68,65,133
6105,TRINITY,2018,53,89,79,168
6105,TRINITY,2018,54,99,104,203
6105,TRINITY,2018,55,107,95,202
6105,TRINITY,2018,56,106,104,210
6105,TRINITY,2018,57,116,98,214
6105,TRINITY,2018,58,113,122,235
6105,TRINITY,2018,59,115,94,209
6105,TRINITY,2018,60,115,94,209
6105,TRINITY,2018,61,149,119,268
6105,TRINITY,2018,62,118,112,230
6105,TRINITY,2018,63,113,105,218
6105,TRINITY,2018,64,138,147,285
6105,TRINITY,2018,65,129,140,269
6105,TRINITY,2018,66,127,118,245
6105,TRINITY,2018,67,128,123,251
6105,TRINITY,2018,68,131,121,252
6105,TRINITY,2018,69,113,118,231
6105,TRINITY,2018,70,131,133,264
6105,TRINITY,2018,71,117,125,242
6105,TRINITY,2018,72,78,98,176
6105,TRINITY,2018,73,80,101,181
6105,TRINITY,2018,74,88,122,210
6105,TRINITY,2018,75,75,82,157
6105,TRINITY,2018,76,77,97,174
6105,TRINITY,2018,77,86,67,153
6105,TRINITY,2018,78,62,65,127
6105,TRINITY,2018,79,66,68,134
6105,TRINITY,2018,80,42,54,96
6105,TRINITY,2018,81,50,54,104
6105,TRINITY,2018,82,33,49,82
6105,TRINITY,2018,83,43,40,83
6105,TRINITY,2018,84,42,40,82
6105,TRINITY,2018,85,50,30,80
6105,TRINITY,2018,86,40,21,61
6105,TRINITY,2018,87,34,23,57
6105,TRINITY,2018,88,20,33,53
6105,TRINITY,2018,89,23,15,38
6105,TRINITY,2018,90,18,13,31
6105,TRINITY,2018,91,13,13,26
6105,TRINITY,2018,92,11,17,28
6105,TRINITY,2018,93,8,6,14
6105,TRINITY,2018,94,3,5,8
6105,TRINITY,2018,95,3,0,3
6105,TRINITY,2018,96,5,0,5
6105,TRINITY,2018,97,0,3,3
6105,TRINITY,2018,98,2,1,3
6105,TRINITY,2018,99,2,0,2
6105,TRINITY,2018,100,3,0,3
6105,TRINITY,2019,0,54,53,107
6105,TRINITY,2019,1,41,61,102
6105,TRINITY,2019,2,57,52,109
6105,TRINITY,2019,3,51,56,107
6105,TRINITY,2019,4,55,66,121
6105,TRINITY,2019,5,53,64,117
6105,TRINITY,2019,6,56,56,112
6105,TRINITY,2019,7,54,54,108
6105,TRINITY,2019,8,52,53,105
6105,TRINITY,2019,9,68,40,108
6105,TRINITY,2019,10,52,54,106
6105,TRINITY,2019,11,51,61,112
6105,TRINITY,2019,12,58,79,137
6105,TRINITY,2019,13,65,80,145
6105,TRINITY,2019,14,74,85,159
6105,TRINITY,2019,15,54,81,135
6105,TRINITY,2019,16,59,65,124
6105,TRINITY,2019,17,66,73,139
6105,TRINITY,2019,18,62,59,121
6105,TRINITY,2019,19,63,63,126
6105,TRINITY,2019,20,81,67,148
6105,TRINITY,2019,21,70,65,135
6105,TRINITY,2019,22,89,70,159
6105,TRINITY,2019,23,84,90,174
6105,TRINITY,2019,24,87,91,178
6105,TRINITY,2019,25,82,80,162
6105,TRINITY,2019,26,102,93,195
6105,TRINITY,2019,27,62,93,155
6105,TRINITY,2019,28,60,72,132
6105,TRINITY,2019,29,67,81,148
6105,TRINITY,2019,30,59,59,118
6105,TRINITY,2019,31,46,62,108
6105,TRINITY,2019,32,51,61,112
6105,TRINITY,2019,33,50,52,102
6105,TRINITY,2019,34,48,74,122
6105,TRINITY,2019,35,49,56,105
6105,TRINITY,2019,36,55,57,112
6105,TRINITY,2019,37,57,76,133
6105,TRINITY,2019,38,53,60,113
6105,TRINITY,2019,39,62,73,135
6105,TRINITY,2019,40,54,73,127
6105,TRINITY,2019,41,70,73,143
6105,TRINITY,2019,42,46,44,90
6105,TRINITY,2019,43,66,62,128
6105,TRINITY,2019,44,54,79,133
6105,TRINITY,2019,45,75,59,134
6105,TRINITY,2019,46,52,52,104
6105,TRINITY,2019,47,53,83,136
6105,TRINITY,2019,48,67,72,139
6105,TRINITY,2019,49,66,61,127
6105,TRINITY,2019,50,64,75,139
6105,TRINITY,2019,51,69,60,129
6105,TRINITY,2019,52,70,89,159
6105,TRINITY,2019,53,71,66,137
6105,TRINITY,2019,54,88,77,165
6105,TRINITY,2019,55,95,101,196
6105,TRINITY,2019,56,109,96,205
6105,TRINITY,2019,57,106,103,209
6105,TRINITY,2019,58,114,96,210
6105,TRINITY,2019,59,112,120,232
6105,TRINITY,2019,60,115,93,208
6105,TRINITY,2019,61,116,93,209
6105,TRINITY,2019,62,143,114,257
6105,TRINITY,2019,63,120,110,230
6105,TRINITY,2019,64,111,103,214
6105,TRINITY,2019,65,138,143,281
6105,TRINITY,2019,66,126,138,264
6105,TRINITY,2019,67,127,117,244
6105,TRINITY,2019,68,127,122,249
6105,TRINITY,2019,69,130,119,249
6105,TRINITY,2019,70,111,115,226
6105,TRINITY,2019,71,130,131,261
6105,TRINITY,2019,72,117,126,243
6105,TRINITY,2019,73,78,95,173
6105,TRINITY,2019,74,78,102,180
6105,TRINITY,2019,75,86,120,206
6105,TRINITY,2019,76,75,79,154
6105,TRINITY,2019,77,76,94,170
6105,TRINITY,2019,78,87,62,149
6105,TRINITY,2019,79,54,63,117
6105,TRINITY,2019,80,67,66,133
6105,TRINITY,2019,81,37,52,89
6105,TRINITY,2019,82,48,50,98
6105,TRINITY,2019,83,34,49,83
6105,TRINITY,2019,84,36,38,74
6105,TRINITY,2019,85,41,40,81
6105,TRINITY,2019,86,47,30,77
6105,TRINITY,2019,87,33,18,51
6105,TRINITY,2019,88,32,21,53
6105,TRINITY,2019,89,18,29,47
6105,TRINITY,2019,90,21,15,36
6105,TRINITY,2019,91,16,8,24
6105,TRINITY,2019,92,10,11,21
6105,TRINITY,2019,93,9,15,24
6105,TRINITY,2019,94,7,4,11
6105,TRINITY,2019,95,2,4,6
6105,TRINITY,2019,96,2,0,2
6105,TRINITY,2019,97,4,0,4
6105,TRINITY,2019,98,0,2,2
6105,TRINITY,2019,99,2,1,3
6105,TRINITY,2019,100,5,0,5
6107,TULARE,2017,0,3426,3956,7382
6107,TULARE,2017,1,3528,3729,7257
6107,TULARE,2017,2,3670,3805,7475
6107,TULARE,2017,3,3740,3914,7654
6107,TULARE,2017,4,3800,4076,7876
6107,TULARE,2017,5,3987,4198,8185
6107,TULARE,2017,6,4068,4238,8306
6107,TULARE,2017,7,4022,4174,8196
6107,TULARE,2017,8,4121,4309,8430
6107,TULARE,2017,9,4099,4378,8477
6107,TULARE,2017,10,4296,4354,8650
6107,TULARE,2017,11,4071,4287,8358
6107,TULARE,2017,12,4000,4273,8273
6107,TULARE,2017,13,3950,4228,8178
6107,TULARE,2017,14,4082,4011,8093
6107,TULARE,2017,15,3720,4025,7745
6107,TULARE,2017,16,3931,4061,7992
6107,TULARE,2017,17,3828,4073,7901
6107,TULARE,2017,18,3718,3845,7563
6107,TULARE,2017,19,3554,3645,7199
6107,TULARE,2017,20,3513,3758,7271
6107,TULARE,2017,21,3409,3621,7030
6107,TULARE,2017,22,3323,3363,6686
6107,TULARE,2017,23,3317,3629,6946
6107,TULARE,2017,24,3528,3720,7248
6107,TULARE,2017,25,3359,3700,7059
6107,TULARE,2017,26,3178,3570,6748
6107,TULARE,2017,27,3165,3440,6605
6107,TULARE,2017,28,3065,3332,6397
6107,TULARE,2017,29,2986,3241,6227
6107,TULARE,2017,30,2988,3266,6254
6107,TULARE,2017,31,3201,3188,6389
6107,TULARE,2017,32,3259,3355,6614
6107,TULARE,2017,33,3271,3281,6552
6107,TULARE,2017,34,3251,3383,6634
6107,TULARE,2017,35,3303,3352,6655
6107,TULARE,2017,36,3196,3421,6617
6107,TULARE,2017,37,3202,3277,6479
6107,TULARE,2017,38,2866,3074,5940
6107,TULARE,2017,39,3035,2922,5957
6107,TULARE,2017,40,2831,2976,5807
6107,TULARE,2017,41,2942,2900,5842
6107,TULARE,2017,42,2751,2825,5576
6107,TULARE,2017,43,2663,2698,5361
6107,TULARE,2017,44,2652,2668,5320
6107,TULARE,2017,45,2676,2710,5386
6107,TULARE,2017,46,2781,2867,5648
6107,TULARE,2017,47,2797,2818,5615
6107,TULARE,2017,48,2640,2704,5344
6107,TULARE,2017,49,2670,2559,5229
6107,TULARE,2017,50,2541,2582,5123
6107,TULARE,2017,51,2501,2570,5071
6107,TULARE,2017,52,2782,2641,5423
6107,TULARE,2017,53,2656,2522,5178
6107,TULARE,2017,54,2499,2590,5089
6107,TULARE,2017,55,2655,2486,5141
6107,TULARE,2017,56,2597,2470,5067
6107,TULARE,2017,57,2542,2515,5057
6107,TULARE,2017,58,2499,2436,4935
6107,TULARE,2017,59,2350,2354,4704
6107,TULARE,2017,60,2352,2206,4558
6107,TULARE,2017,61,2346,2224,4570
6107,TULARE,2017,62,2202,2073,4275
6107,TULARE,2017,63,2229,1991,4220
6107,TULARE,2017,64,2092,1941,4033
6107,TULARE,2017,65,2004,1785,3789
6107,TULARE,2017,66,1865,1747,3612
6107,TULARE,2017,67,2019,1709,3728
6107,TULARE,2017,68,1826,1823,3649
6107,TULARE,2017,69,1834,1638,3472
6107,TULARE,2017,70,1774,1643,3417
6107,TULARE,2017,71,1553,1355,2908
6107,TULARE,2017,72,1419,1274,2693
6107,TULARE,2017,73,1286,1151,2437
6107,TULARE,2017,74,1268,1094,2362
6107,TULARE,2017,75,1232,964,2196
6107,TULARE,2017,76,1058,909,1967
6107,TULARE,2017,77,1012,833,1845
6107,TULARE,2017,78,988,765,1753
6107,TULARE,2017,79,893,698,1591
6107,TULARE,2017,80,828,669,1497
6107,TULARE,2017,81,801,615,1416
6107,TULARE,2017,82,784,521,1305
6107,TULARE,2017,83,678,477,1155
6107,TULARE,2017,84,597,408,1005
6107,TULARE,2017,85,659,406,1065
6107,TULARE,2017,86,582,353,935
6107,TULARE,2017,87,488,321,809
6107,TULARE,2017,88,472,278,750
6107,TULARE,2017,89,436,222,658
6107,TULARE,2017,90,380,196,576
6107,TULARE,2017,91,296,143,439
6107,TULARE,2017,92,208,115,323
6107,TULARE,2017,93,143,78,221
6107,TULARE,2017,94,142,68,210
6107,TULARE,2017,95,94,54,148
6107,TULARE,2017,96,88,41,129
6107,TULARE,2017,97,61,13,74
6107,TULARE,2017,98,22,15,37
6107,TULARE,2017,99,19,10,29
6107,TULARE,2017,100,30,8,38
6107,TULARE,2018,0,3467,3849,7316
6107,TULARE,2018,1,3404,3926,7330
6107,TULARE,2018,2,3565,3774,7339
6107,TULARE,2018,3,3682,3845,7527
6107,TULARE,2018,4,3775,3955,7730
6107,TULARE,2018,5,3839,4115,7954
6107,TULARE,2018,6,4012,4213,8225
6107,TULARE,2018,7,4085,4260,8345
6107,TULARE,2018,8,4064,4204,8268
6107,TULARE,2018,9,4140,4336,8476
6107,TULARE,2018,10,4122,4391,8513
6107,TULARE,2018,11,4298,4352,8650
6107,TULARE,2018,12,4069,4285,8354
6107,TULARE,2018,13,3998,4266,8264
6107,TULARE,2018,14,3947,4234,8181
6107,TULARE,2018,15,4087,4044,8131
6107,TULARE,2018,16,3697,4019,7716
6107,TULARE,2018,17,3918,4073,7991
6107,TULARE,2018,18,3768,3965,7733
6107,TULARE,2018,19,3702,3835,7537
6107,TULARE,2018,20,3515,3639,7154
6107,TULARE,2018,21,3502,3741,7243
6107,TULARE,2018,22,3402,3596,6998
6107,TULARE,2018,23,3305,3359,6664
6107,TULARE,2018,24,3310,3606,6916
6107,TULARE,2018,25,3523,3707,7230
6107,TULARE,2018,26,3368,3699,7067
6107,TULARE,2018,27,3207,3603,6810
6107,TULARE,2018,28,3187,3459,6646
6107,TULARE,2018,29,3066,3319,6385
6107,TULARE,2018,30,3007,3250,6257
6107,TULARE,2018,31,3032,3303,6335
6107,TULARE,2018,32,3224,3224,6448
6107,TULARE,2018,33,3267,3351,6618
6107,TULARE,2018,34,3301,3317,6618
6107,TULARE,2018,35,3267,3418,6685
6107,TULARE,2018,36,3308,3337,6645
6107,TULARE,2018,37,3185,3420,6605
6107,TULARE,2018,38,3194,3270,6464
6107,TULARE,2018,39,2861,3065,5926
6107,TULARE,2018,40,3046,2925,5971
6107,TULARE,2018,41,2828,2970,5798
6107,TULARE,2018,42,2940,2875,5815
6107,TULARE,2018,43,2747,2831,5578
6107,TULARE,2018,44,2654,2688,5342
6107,TULARE,2018,45,2661,2669,5330
6107,TULARE,2018,46,2674,2690,5364
6107,TULARE,2018,47,2769,2870,5639
6107,TULARE,2018,48,2784,2809,5593
6107,TULARE,2018,49,2633,2692,5325
6107,TULARE,2018,50,2668,2529,5197
6107,TULARE,2018,51,2519,2557,5076
6107,TULARE,2018,52,2500,2559,5059
6107,TULARE,2018,53,2764,2628,5392
6107,TULARE,2018,54,2639,2503,5142
6107,TULARE,2018,55,2477,2556,5033
6107,TULARE,2018,56,2639,2465,5104
6107,TULARE,2018,57,2569,2431,5000
6107,TULARE,2018,58,2533,2495,5028
6107,TULARE,2018,59,2465,2389,4854
6107,TULARE,2018,60,2334,2316,4650
6107,TULARE,2018,61,2337,2170,4507
6107,TULARE,2018,62,2332,2201,4533
6107,TULARE,2018,63,2195,2033,4228
6107,TULARE,2018,64,2199,1949,4148
6107,TULARE,2018,65,2085,1908,3993
6107,TULARE,2018,66,1986,1774,3760
6107,TULARE,2018,67,1841,1725,3566
6107,TULARE,2018,68,2002,1684,3686
6107,TULARE,2018,69,1823,1786,3609
6107,TULARE,2018,70,1797,1634,3431
6107,TULARE,2018,71,1744,1602,3346
6107,TULARE,2018,72,1519,1318,2837
6107,TULARE,2018,73,1383,1241,2624
6107,TULARE,2018,74,1266,1120,2386
6107,TULARE,2018,75,1269,1062,2331
6107,TULARE,2018,76,1198,918,2116
6107,TULARE,2018,77,1021,880,1901
6107,TULARE,2018,78,979,804,1783
6107,TULARE,2018,79,963,737,1700
6107,TULARE,2018,80,874,678,1552
6107,TULARE,2018,81,798,613,1411
6107,TULARE,2018,82,755,569,1324
6107,TULARE,2018,83,735,489,1224
6107,TULARE,2018,84,652,434,1086
6107,TULARE,2018,85,608,399,1007
6107,TULARE,2018,86,583,353,936
6107,TULARE,2018,87,514,317,831
6107,TULARE,2018,88,461,295,756
6107,TULARE,2018,89,429,247,676
6107,TULARE,2018,90,377,189,566
6107,TULARE,2018,91,313,164,477
6107,TULARE,2018,92,243,117,360
6107,TULARE,2018,93,181,94,275
6107,TULARE,2018,94,123,71,194
6107,TULARE,2018,95,117,56,173
6107,TULARE,2018,96,67,42,109
6107,TULARE,2018,97,69,27,96
6107,TULARE,2018,98,34,8,42
6107,TULARE,2018,99,19,11,30
6107,TULARE,2018,100,32,13,45
6107,TULARE,2019,0,3458,3837,7295
6107,TULARE,2019,1,3448,3828,7276
6107,TULARE,2019,2,3453,3964,7417
6107,TULARE,2019,3,3592,3808,7400
6107,TULARE,2019,4,3708,3889,7597
6107,TULARE,2019,5,3805,4004,7809
6107,TULARE,2019,6,3870,4129,7999
6107,TULARE,2019,7,4036,4233,8269
6107,TULARE,2019,8,4125,4296,8421
6107,TULARE,2019,9,4083,4217,8300
6107,TULARE,2019,10,4169,4345,8514
6107,TULARE,2019,11,4123,4389,8512
6107,TULARE,2019,12,4297,4350,8647
6107,TULARE,2019,13,4069,4280,8349
6107,TULARE,2019,14,3996,4271,8267
6107,TULARE,2019,15,3952,4264,8216
6107,TULARE,2019,16,4068,4042,8110
6107,TULARE,2019,17,3687,4031,7718
6107,TULARE,2019,18,3867,3974,7841
6107,TULARE,2019,19,3757,3969,7726
6107,TULARE,2019,20,3663,3836,7499
6107,TULARE,2019,21,3507,3621,7128
6107,TULARE,2019,22,3490,3717,7207
6107,TULARE,2019,23,3386,3595,6981
6107,TULARE,2019,24,3297,3338,6635
6107,TULARE,2019,25,3305,3602,6907
6107,TULARE,2019,26,3535,3712,7247
6107,TULARE,2019,27,3385,3732,7117
6107,TULARE,2019,28,3235,3617,6852
6107,TULARE,2019,29,3187,3459,6646
6107,TULARE,2019,30,3094,3325,6419
6107,TULARE,2019,31,3051,3283,6334
6107,TULARE,2019,32,3061,3345,6406
6107,TULARE,2019,33,3238,3220,6458
6107,TULARE,2019,34,3300,3367,6667
6107,TULARE,2019,35,3321,3351,6672
6107,TULARE,2019,36,3265,3405,6670
6107,TULARE,2019,37,3296,3334,6630
6107,TULARE,2019,38,3181,3408,6589
6107,TULARE,2019,39,3188,3261,6449
6107,TULARE,2019,40,2867,3067,5934
6107,TULARE,2019,41,3042,2925,5967
6107,TULARE,2019,42,2831,2945,5776
6107,TULARE,2019,43,2934,2886,5820
6107,TULARE,2019,44,2738,2814,5552
6107,TULARE,2019,45,2663,2695,5358
6107,TULARE,2019,46,2658,2645,5303
6107,TULARE,2019,47,2668,2689,5357
6107,TULARE,2019,48,2760,2872,5632
6107,TULARE,2019,49,2774,2794,5568
6107,TULARE,2019,50,2624,2666,5290
6107,TULARE,2019,51,2642,2506,5148
6107,TULARE,2019,52,2514,2548,5062
6107,TULARE,2019,53,2494,2539,5033
6107,TULARE,2019,54,2752,2607,5359
6107,TULARE,2019,55,2625,2472,5097
6107,TULARE,2019,56,2454,2537,4991
6107,TULARE,2019,57,2615,2424,5039
6107,TULARE,2019,58,2559,2421,4980
6107,TULARE,2019,59,2509,2453,4962
6107,TULARE,2019,60,2441,2356,4797
6107,TULARE,2019,61,2318,2282,4600
6107,TULARE,2019,62,2323,2144,4467
6107,TULARE,2019,63,2319,2165,4484
6107,TULARE,2019,64,2163,1999,4162
6107,TULARE,2019,65,2191,1921,4112
6107,TULARE,2019,66,2065,1885,3950
6107,TULARE,2019,67,1961,1749,3710
6107,TULARE,2019,68,1835,1706,3541
6107,TULARE,2019,69,1982,1664,3646
6107,TULARE,2019,70,1809,1770,3579
6107,TULARE,2019,71,1783,1595,3378
6107,TULARE,2019,72,1710,1561,3271
6107,TULARE,2019,73,1495,1280,2775
6107,TULARE,2019,74,1361,1204,2565
6107,TULARE,2019,75,1249,1090,2339
6107,TULARE,2019,76,1236,1027,2263
6107,TULARE,2019,77,1155,889,2044
6107,TULARE,2019,78,993,848,1841
6107,TULARE,2019,79,962,776,1738
6107,TULARE,2019,80,948,711,1659
6107,TULARE,2019,81,838,638,1476
6107,TULARE,2019,82,759,568,1327
6107,TULARE,2019,83,708,525,1233
6107,TULARE,2019,84,714,442,1156
6107,TULARE,2019,85,660,418,1078
6107,TULARE,2019,86,549,341,890
6107,TULARE,2019,87,531,321,852
6107,TULARE,2019,88,472,294,766
6107,TULARE,2019,89,416,258,674
6107,TULARE,2019,90,367,216,583
6107,TULARE,2019,91,312,137,449
6107,TULARE,2019,92,265,122,387
6107,TULARE,2019,93,212,93,305
6107,TULARE,2019,94,151,73,224
6107,TULARE,2019,95,98,62,160
6107,TULARE,2019,96,94,38,132
6107,TULARE,2019,97,50,26,76
6107,TULARE,2019,98,44,20,64
6107,TULARE,2019,99,24,6,30
6107,TULARE,2019,100,36,14,50
6109,TUOLUMNE,2017,0,211,228,439
6109,TUOLUMNE,2017,1,232,198,430
6109,TUOLUMNE,2017,2,233,233,466
6109,TUOLUMNE,2017,3,227,227,454
6109,TUOLUMNE,2017,4,231,222,453
6109,TUOLUMNE,2017,5,243,226,469
6109,TUOLUMNE,2017,6,223,224,447
6109,TUOLUMNE,2017,7,245,206,451
6109,TUOLUMNE,2017,8,222,248,470
6109,TUOLUMNE,2017,9,223,246,469
6109,TUOLUMNE,2017,10,227,261,488
6109,TUOLUMNE,2017,11,264,279,543
6109,TUOLUMNE,2017,12,243,256,499
6109,TUOLUMNE,2017,13,255,264,519
6109,TUOLUMNE,2017,14,230,264,494
6109,TUOLUMNE,2017,15,246,236,482
6109,TUOLUMNE,2017,16,215,304,519
6109,TUOLUMNE,2017,17,276,282,558
6109,TUOLUMNE,2017,18,251,282,533
6109,TUOLUMNE,2017,19,297,310,607
6109,TUOLUMNE,2017,20,316,372,688
6109,TUOLUMNE,2017,21,300,382,682
6109,TUOLUMNE,2017,22,308,394,702
6109,TUOLUMNE,2017,23,311,386,697
6109,TUOLUMNE,2017,24,312,416,728
6109,TUOLUMNE,2017,25,298,438,736
6109,TUOLUMNE,2017,26,265,458,723
6109,TUOLUMNE,2017,27,281,374,655
6109,TUOLUMNE,2017,28,260,342,602
6109,TUOLUMNE,2017,29,218,362,580
6109,TUOLUMNE,2017,30,247,363,610
6109,TUOLUMNE,2017,31,240,341,581
6109,TUOLUMNE,2017,32,248,334,582
6109,TUOLUMNE,2017,33,215,340,555
6109,TUOLUMNE,2017,34,258,372,630
6109,TUOLUMNE,2017,35,230,343,573
6109,TUOLUMNE,2017,36,242,332,574
6109,TUOLUMNE,2017,37,248,338,586
6109,TUOLUMNE,2017,38,247,319,566
6109,TUOLUMNE,2017,39,237,315,552
6109,TUOLUMNE,2017,40,236,328,564
6109,TUOLUMNE,2017,41,181,285,466
6109,TUOLUMNE,2017,42,194,323,517
6109,TUOLUMNE,2017,43,197,296,493
6109,TUOLUMNE,2017,44,209,324,533
6109,TUOLUMNE,2017,45,232,283,515
6109,TUOLUMNE,2017,46,261,350,611
6109,TUOLUMNE,2017,47,278,329,607
6109,TUOLUMNE,2017,48,284,344,628
6109,TUOLUMNE,2017,49,268,318,586
6109,TUOLUMNE,2017,50,246,307,553
6109,TUOLUMNE,2017,51,285,297,582
6109,TUOLUMNE,2017,52,310,361,671
6109,TUOLUMNE,2017,53,307,356,663
6109,TUOLUMNE,2017,54,361,329,690
6109,TUOLUMNE,2017,55,352,338,690
6109,TUOLUMNE,2017,56,417,366,783
6109,TUOLUMNE,2017,57,428,446,874
6109,TUOLUMNE,2017,58,423,456,879
6109,TUOLUMNE,2017,59,439,437,876
6109,TUOLUMNE,2017,60,479,393,872
6109,TUOLUMNE,2017,61,525,412,937
6109,TUOLUMNE,2017,62,468,451,919
6109,TUOLUMNE,2017,63,510,445,955
6109,TUOLUMNE,2017,64,505,440,945
6109,TUOLUMNE,2017,65,504,459,963
6109,TUOLUMNE,2017,66,431,450,881
6109,TUOLUMNE,2017,67,440,456,896
6109,TUOLUMNE,2017,68,433,458,891
6109,TUOLUMNE,2017,69,458,428,886
6109,TUOLUMNE,2017,70,465,435,900
6109,TUOLUMNE,2017,71,384,384,768
6109,TUOLUMNE,2017,72,386,332,718
6109,TUOLUMNE,2017,73,366,330,696
6109,TUOLUMNE,2017,74,306,337,643
6109,TUOLUMNE,2017,75,291,293,584
6109,TUOLUMNE,2017,76,288,255,543
6109,TUOLUMNE,2017,77,265,240,505
6109,TUOLUMNE,2017,78,274,251,525
6109,TUOLUMNE,2017,79,226,211,437
6109,TUOLUMNE,2017,80,211,208,419
6109,TUOLUMNE,2017,81,205,157,362
6109,TUOLUMNE,2017,82,201,134,335
6109,TUOLUMNE,2017,83,198,154,352
6109,TUOLUMNE,2017,84,159,151,310
6109,TUOLUMNE,2017,85,174,132,306
6109,TUOLUMNE,2017,86,155,100,255
6109,TUOLUMNE,2017,87,128,89,217
6109,TUOLUMNE,2017,88,125,84,209
6109,TUOLUMNE,2017,89,93,61,154
6109,TUOLUMNE,2017,90,116,63,179
6109,TUOLUMNE,2017,91,81,47,128
6109,TUOLUMNE,2017,92,43,43,86
6109,TUOLUMNE,2017,93,31,24,55
6109,TUOLUMNE,2017,94,43,22,65
6109,TUOLUMNE,2017,95,34,13,47
6109,TUOLUMNE,2017,96,24,12,36
6109,TUOLUMNE,2017,97,5,6,11
6109,TUOLUMNE,2017,98,10,6,16
6109,TUOLUMNE,2017,99,12,0,12
6109,TUOLUMNE,2017,100,2,0,2
6109,TUOLUMNE,2018,0,228,218,446
6109,TUOLUMNE,2018,1,208,225,433
6109,TUOLUMNE,2018,2,231,199,430
6109,TUOLUMNE,2018,3,237,230,467
6109,TUOLUMNE,2018,4,222,229,451
6109,TUOLUMNE,2018,5,233,219,452
6109,TUOLUMNE,2018,6,241,229,470
6109,TUOLUMNE,2018,7,223,223,446
6109,TUOLUMNE,2018,8,253,212,465
6109,TUOLUMNE,2018,9,220,249,469
6109,TUOLUMNE,2018,10,229,247,476
6109,TUOLUMNE,2018,11,226,261,487
6109,TUOLUMNE,2018,12,262,282,544
6109,TUOLUMNE,2018,13,243,252,495
6109,TUOLUMNE,2018,14,258,268,526
6109,TUOLUMNE,2018,15,228,262,490
6109,TUOLUMNE,2018,16,248,233,481
6109,TUOLUMNE,2018,17,213,315,528
6109,TUOLUMNE,2018,18,281,278,559
6109,TUOLUMNE,2018,19,251,286,537
6109,TUOLUMNE,2018,20,292,347,639
6109,TUOLUMNE,2018,21,313,386,699
6109,TUOLUMNE,2018,22,302,392,694
6109,TUOLUMNE,2018,23,309,373,682
6109,TUOLUMNE,2018,24,308,414,722
6109,TUOLUMNE,2018,25,311,418,729
6109,TUOLUMNE,2018,26,301,440,741
6109,TUOLUMNE,2018,27,260,463,723
6109,TUOLUMNE,2018,28,282,379,661
6109,TUOLUMNE,2018,29,259,338,597
6109,TUOLUMNE,2018,30,215,365,580
6109,TUOLUMNE,2018,31,246,350,596
6109,TUOLUMNE,2018,32,238,325,563
6109,TUOLUMNE,2018,33,248,339,587
6109,TUOLUMNE,2018,34,222,347,569
6109,TUOLUMNE,2018,35,254,342,596
6109,TUOLUMNE,2018,36,231,349,580
6109,TUOLUMNE,2018,37,241,326,567
6109,TUOLUMNE,2018,38,249,338,587
6109,TUOLUMNE,2018,39,247,339,586
6109,TUOLUMNE,2018,40,233,317,550
6109,TUOLUMNE,2018,41,241,315,556
6109,TUOLUMNE,2018,42,178,296,474
6109,TUOLUMNE,2018,43,191,331,522
6109,TUOLUMNE,2018,44,196,292,488
6109,TUOLUMNE,2018,45,211,296,507
6109,TUOLUMNE,2018,46,234,286,520
6109,TUOLUMNE,2018,47,265,351,616
6109,TUOLUMNE,2018,48,273,338,611
6109,TUOLUMNE,2018,49,284,335,619
6109,TUOLUMNE,2018,50,275,305,580
6109,TUOLUMNE,2018,51,241,304,545
6109,TUOLUMNE,2018,52,286,286,572
6109,TUOLUMNE,2018,53,304,354,658
6109,TUOLUMNE,2018,54,310,360,670
6109,TUOLUMNE,2018,55,355,305,660
6109,TUOLUMNE,2018,56,352,337,689
6109,TUOLUMNE,2018,57,425,366,791
6109,TUOLUMNE,2018,58,434,460,894
6109,TUOLUMNE,2018,59,430,449,879
6109,TUOLUMNE,2018,60,442,431,873
6109,TUOLUMNE,2018,61,479,418,897
6109,TUOLUMNE,2018,62,526,406,932
6109,TUOLUMNE,2018,63,483,453,936
6109,TUOLUMNE,2018,64,505,441,946
6109,TUOLUMNE,2018,65,508,429,937
6109,TUOLUMNE,2018,66,503,448,951
6109,TUOLUMNE,2018,67,431,450,881
6109,TUOLUMNE,2018,68,438,445,883
6109,TUOLUMNE,2018,69,431,454,885
6109,TUOLUMNE,2018,70,455,411,866
6109,TUOLUMNE,2018,71,458,422,880
6109,TUOLUMNE,2018,72,375,382,757
6109,TUOLUMNE,2018,73,384,320,704
6109,TUOLUMNE,2018,74,360,321,681
6109,TUOLUMNE,2018,75,298,332,630
6109,TUOLUMNE,2018,76,292,283,575
6109,TUOLUMNE,2018,77,280,245,525
6109,TUOLUMNE,2018,78,257,227,484
6109,TUOLUMNE,2018,79,263,242,505
6109,TUOLUMNE,2018,80,222,201,423
6109,TUOLUMNE,2018,81,205,197,402
6109,TUOLUMNE,2018,82,197,143,340
6109,TUOLUMNE,2018,83,187,121,308
6109,TUOLUMNE,2018,84,189,144,333
6109,TUOLUMNE,2018,85,155,138,293
6109,TUOLUMNE,2018,86,167,117,284
6109,TUOLUMNE,2018,87,129,97,226
6109,TUOLUMNE,2018,88,124,82,206
6109,TUOLUMNE,2018,89,109,75,184
6109,TUOLUMNE,2018,90,93,50,143
6109,TUOLUMNE,2018,91,102,56,158
6109,TUOLUMNE,2018,92,66,37,103
6109,TUOLUMNE,2018,93,32,32,64
6109,TUOLUMNE,2018,94,24,19,43
6109,TUOLUMNE,2018,95,35,19,54
6109,TUOLUMNE,2018,96,25,13,38
6109,TUOLUMNE,2018,97,17,9,26
6109,TUOLUMNE,2018,98,7,2,9
6109,TUOLUMNE,2018,99,7,5,12
6109,TUOLUMNE,2018,100,9,0,9
6109,TUOLUMNE,2019,0,223,232,455
6109,TUOLUMNE,2019,1,224,216,440
6109,TUOLUMNE,2019,2,207,226,433
6109,TUOLUMNE,2019,3,234,196,430
6109,TUOLUMNE,2019,4,233,231,464
6109,TUOLUMNE,2019,5,224,227,451
6109,TUOLUMNE,2019,6,231,222,453
6109,TUOLUMNE,2019,7,241,228,469
6109,TUOLUMNE,2019,8,227,229,456
6109,TUOLUMNE,2019,9,251,215,466
6109,TUOLUMNE,2019,10,227,251,478
6109,TUOLUMNE,2019,11,227,247,474
6109,TUOLUMNE,2019,12,224,264,488
6109,TUOLUMNE,2019,13,262,279,541
6109,TUOLUMNE,2019,14,246,256,502
6109,TUOLUMNE,2019,15,256,267,523
6109,TUOLUMNE,2019,16,230,264,494
6109,TUOLUMNE,2019,17,244,241,485
6109,TUOLUMNE,2019,18,219,311,530
6109,TUOLUMNE,2019,19,281,280,561
6109,TUOLUMNE,2019,20,248,326,574
6109,TUOLUMNE,2019,21,289,362,651
6109,TUOLUMNE,2019,22,315,396,711
6109,TUOLUMNE,2019,23,302,373,675
6109,TUOLUMNE,2019,24,305,401,706
6109,TUOLUMNE,2019,25,307,415,722
6109,TUOLUMNE,2019,26,314,422,736
6109,TUOLUMNE,2019,27,296,446,742
6109,TUOLUMNE,2019,28,262,467,729
6109,TUOLUMNE,2019,29,281,376,657
6109,TUOLUMNE,2019,30,256,341,597
6109,TUOLUMNE,2019,31,212,351,563
6109,TUOLUMNE,2019,32,244,332,576
6109,TUOLUMNE,2019,33,238,330,568
6109,TUOLUMNE,2019,34,255,347,602
6109,TUOLUMNE,2019,35,218,318,536
6109,TUOLUMNE,2019,36,255,348,603
6109,TUOLUMNE,2019,37,227,347,574
6109,TUOLUMNE,2019,38,242,325,567
6109,TUOLUMNE,2019,39,248,359,607
6109,TUOLUMNE,2019,40,243,342,585
6109,TUOLUMNE,2019,41,237,303,540
6109,TUOLUMNE,2019,42,238,326,564
6109,TUOLUMNE,2019,43,178,304,482
6109,TUOLUMNE,2019,44,191,328,519
6109,TUOLUMNE,2019,45,198,264,462
6109,TUOLUMNE,2019,46,212,296,508
6109,TUOLUMNE,2019,47,237,293,530
6109,TUOLUMNE,2019,48,261,359,620
6109,TUOLUMNE,2019,49,277,332,609
6109,TUOLUMNE,2019,50,290,318,608
6109,TUOLUMNE,2019,51,271,304,575
6109,TUOLUMNE,2019,52,243,293,536
6109,TUOLUMNE,2019,53,285,277,562
6109,TUOLUMNE,2019,54,306,360,666
6109,TUOLUMNE,2019,55,305,337,642
6109,TUOLUMNE,2019,56,354,312,666
6109,TUOLUMNE,2019,57,363,344,707
6109,TUOLUMNE,2019,58,429,384,813
6109,TUOLUMNE,2019,59,438,441,879
6109,TUOLUMNE,2019,60,427,440,867
6109,TUOLUMNE,2019,61,458,445,903
6109,TUOLUMNE,2019,62,484,416,900
6109,TUOLUMNE,2019,63,543,414,957
6109,TUOLUMNE,2019,64,483,442,925
6109,TUOLUMNE,2019,65,498,433,931
6109,TUOLUMNE,2019,66,506,416,922
6109,TUOLUMNE,2019,67,501,450,951
6109,TUOLUMNE,2019,68,430,440,870
6109,TUOLUMNE,2019,69,433,443,876
6109,TUOLUMNE,2019,70,433,443,876
6109,TUOLUMNE,2019,71,444,404,848
6109,TUOLUMNE,2019,72,452,416,868
6109,TUOLUMNE,2019,73,367,368,735
6109,TUOLUMNE,2019,74,379,313,692
6109,TUOLUMNE,2019,75,353,315,668
6109,TUOLUMNE,2019,76,299,319,618
6109,TUOLUMNE,2019,77,275,276,551
6109,TUOLUMNE,2019,78,275,230,505
6109,TUOLUMNE,2019,79,250,221,471
6109,TUOLUMNE,2019,80,260,236,496
6109,TUOLUMNE,2019,81,211,193,404
6109,TUOLUMNE,2019,82,198,184,382
6109,TUOLUMNE,2019,83,189,133,322
6109,TUOLUMNE,2019,84,178,115,293
6109,TUOLUMNE,2019,85,180,137,317
6109,TUOLUMNE,2019,86,147,127,274
6109,TUOLUMNE,2019,87,141,109,250
6109,TUOLUMNE,2019,88,127,89,216
6109,TUOLUMNE,2019,89,100,70,170
6109,TUOLUMNE,2019,90,104,67,171
6109,TUOLUMNE,2019,91,81,41,122
6109,TUOLUMNE,2019,92,88,48,136
6109,TUOLUMNE,2019,93,57,34,91
6109,TUOLUMNE,2019,94,26,25,51
6109,TUOLUMNE,2019,95,21,15,36
6109,TUOLUMNE,2019,96,24,15,39
6109,TUOLUMNE,2019,97,15,9,24
6109,TUOLUMNE,2019,98,9,7,16
6109,TUOLUMNE,2019,99,3,1,4
6109,TUOLUMNE,2019,100,9,2,11
6111,VENTURA,2017,0,4782,5172,9954
6111,VENTURA,2017,1,4734,5119,9853
6111,VENTURA,2017,2,5012,5270,10282
6111,VENTURA,2017,3,5058,5331,10389
6111,VENTURA,2017,4,5197,5377,10574
6111,VENTURA,2017,5,5164,5424,10588
6111,VENTURA,2017,6,5404,5676,11080
6111,VENTURA,2017,7,5233,5419,10652
6111,VENTURA,2017,8,5438,5609,11047
6111,VENTURA,2017,9,5536,5804,11340
6111,VENTURA,2017,10,5666,5785,11451
6111,VENTURA,2017,11,5628,5861,11489
6111,VENTURA,2017,12,5683,5850,11533
6111,VENTURA,2017,13,5658,5840,11498
6111,VENTURA,2017,14,5563,5850,11413
6111,VENTURA,2017,15,5612,5837,11449
6111,VENTURA,2017,16,5728,5793,11521
6111,VENTURA,2017,17,5774,5937,11711
6111,VENTURA,2017,18,6040,6607,12647
6111,VENTURA,2017,19,6169,6515,12684
6111,VENTURA,2017,20,6233,6448,12681
6111,VENTURA,2017,21,6147,6595,12742
6111,VENTURA,2017,22,5892,6422,12314
6111,VENTURA,2017,23,6095,6435,12530
6111,VENTURA,2017,24,6252,6643,12895
6111,VENTURA,2017,25,5621,6256,11877
6111,VENTURA,2017,26,5309,6132,11441
6111,VENTURA,2017,27,5152,5712,10864
6111,VENTURA,2017,28,4939,5515,10454
6111,VENTURA,2017,29,4688,5466,10154
6111,VENTURA,2017,30,4902,5491,10393
6111,VENTURA,2017,31,4897,5498,10395
6111,VENTURA,2017,32,5138,5637,10775
6111,VENTURA,2017,33,5178,5618,10796
6111,VENTURA,2017,34,5205,5558,10763
6111,VENTURA,2017,35,5325,5637,10962
6111,VENTURA,2017,36,5222,5426,10648
6111,VENTURA,2017,37,5242,5768,11010
6111,VENTURA,2017,38,5158,5303,10461
6111,VENTURA,2017,39,5068,5246,10314
6111,VENTURA,2017,40,5071,5110,10181
6111,VENTURA,2017,41,5038,4993,10031
6111,VENTURA,2017,42,5415,5246,10661
6111,VENTURA,2017,43,5190,4984,10174
6111,VENTURA,2017,44,5286,5073,10359
6111,VENTURA,2017,45,5452,5276,10728
6111,VENTURA,2017,46,5710,5575,11285
6111,VENTURA,2017,47,5883,5994,11877
6111,VENTURA,2017,48,5669,5680,11349
6111,VENTURA,2017,49,5503,5510,11013
6111,VENTURA,2017,50,5612,5572,11184
6111,VENTURA,2017,51,5730,5421,11151
6111,VENTURA,2017,52,6129,5946,12075
6111,VENTURA,2017,53,6236,5929,12165
6111,VENTURA,2017,54,6269,6034,12303
6111,VENTURA,2017,55,6133,6039,12172
6111,VENTURA,2017,56,6283,5963,12246
6111,VENTURA,2017,57,6574,6106,12680
6111,VENTURA,2017,58,6301,5738,12039
6111,VENTURA,2017,59,6070,5904,11974
6111,VENTURA,2017,60,5823,5563,11386
6111,VENTURA,2017,61,5723,5444,11167
6111,VENTURA,2017,62,5633,5369,11002
6111,VENTURA,2017,63,5250,5012,10262
6111,VENTURA,2017,64,5218,4720,9938
6111,VENTURA,2017,65,4741,4392,9133
6111,VENTURA,2017,66,4642,4193,8835
6111,VENTURA,2017,67,4615,4192,8807
6111,VENTURA,2017,68,4404,4027,8431
6111,VENTURA,2017,69,4294,3891,8185
6111,VENTURA,2017,70,4302,3909,8211
6111,VENTURA,2017,71,3392,3192,6584
6111,VENTURA,2017,72,3203,2865,6068
6111,VENTURA,2017,73,3104,2781,5885
6111,VENTURA,2017,74,3146,2618,5764
6111,VENTURA,2017,75,2709,2340,5049
6111,VENTURA,2017,76,2453,2078,4531
6111,VENTURA,2017,77,2323,1912,4235
6111,VENTURA,2017,78,2136,1804,3940
6111,VENTURA,2017,79,2065,1659,3724
6111,VENTURA,2017,80,2007,1497,3504
6111,VENTURA,2017,81,1862,1360,3222
6111,VENTURA,2017,82,1735,1301,3036
6111,VENTURA,2017,83,1579,1189,2768
6111,VENTURA,2017,84,1538,1115,2653
6111,VENTURA,2017,85,1572,1123,2695
6111,VENTURA,2017,86,1379,870,2249
6111,VENTURA,2017,87,1303,841,2144
6111,VENTURA,2017,88,1116,647,1763
6111,VENTURA,2017,89,1016,597,1613
6111,VENTURA,2017,90,948,529,1477
6111,VENTURA,2017,91,855,453,1308
6111,VENTURA,2017,92,678,279,957
6111,VENTURA,2017,93,500,205,705
6111,VENTURA,2017,94,452,205,657
6111,VENTURA,2017,95,380,130,510
6111,VENTURA,2017,96,264,103,367
6111,VENTURA,2017,97,150,54,204
6111,VENTURA,2017,98,93,33,126
6111,VENTURA,2017,99,70,11,81
6111,VENTURA,2017,100,111,27,138
6111,VENTURA,2018,0,4710,5221,9931
6111,VENTURA,2018,1,4763,5157,9920
6111,VENTURA,2018,2,4779,5145,9924
6111,VENTURA,2018,3,5031,5283,10314
6111,VENTURA,2018,4,5081,5357,10438
6111,VENTURA,2018,5,5222,5382,10604
6111,VENTURA,2018,6,5175,5436,10611
6111,VENTURA,2018,7,5408,5681,11089
6111,VENTURA,2018,8,5237,5425,10662
6111,VENTURA,2018,9,5450,5612,11062
6111,VENTURA,2018,10,5540,5809,11349
6111,VENTURA,2018,11,5677,5798,11475
6111,VENTURA,2018,12,5653,5870,11523
6111,VENTURA,2018,13,5700,5856,11556
6111,VENTURA,2018,14,5669,5832,11501
6111,VENTURA,2018,15,5577,5902,11479
6111,VENTURA,2018,16,5564,5764,11328
6111,VENTURA,2018,17,5728,5762,11490
6111,VENTURA,2018,18,6268,6595,12863
6111,VENTURA,2018,19,6172,6641,12813
6111,VENTURA,2018,20,5961,6343,12304
6111,VENTURA,2018,21,6089,6274,12363
6111,VENTURA,2018,22,6090,6588,12678
6111,VENTURA,2018,23,5819,6327,12146
6111,VENTURA,2018,24,6041,6369,12410
6111,VENTURA,2018,25,6076,6479,12555
6111,VENTURA,2018,26,5493,6108,11601
6111,VENTURA,2018,27,5330,6122,11452
6111,VENTURA,2018,28,5145,5711,10856
6111,VENTURA,2018,29,4938,5494,10432
6111,VENTURA,2018,30,4686,5435,10121
6111,VENTURA,2018,31,4900,5508,10408
6111,VENTURA,2018,32,4916,5500,10416
6111,VENTURA,2018,33,5144,5662,10806
6111,VENTURA,2018,34,5187,5631,10818
6111,VENTURA,2018,35,5216,5554,10770
6111,VENTURA,2018,36,5342,5658,11000
6111,VENTURA,2018,37,5257,5434,10691
6111,VENTURA,2018,38,5267,5783,11050
6111,VENTURA,2018,39,5200,5329,10529
6111,VENTURA,2018,40,5075,5251,10326
6111,VENTURA,2018,41,5056,5081,10137
6111,VENTURA,2018,42,5020,4977,9997
6111,VENTURA,2018,43,5410,5263,10673
6111,VENTURA,2018,44,5178,4974,10152
6111,VENTURA,2018,45,5278,5046,10324
6111,VENTURA,2018,46,5453,5267,10720
6111,VENTURA,2018,47,5682,5564,11246
6111,VENTURA,2018,48,5881,5981,11862
6111,VENTURA,2018,49,5663,5669,11332
6111,VENTURA,2018,50,5495,5510,11005
6111,VENTURA,2018,51,5583,5517,11100
6111,VENTURA,2018,52,5706,5407,11113
6111,VENTURA,2018,53,6110,5929,12039
6111,VENTURA,2018,54,6218,5872,12090
6111,VENTURA,2018,55,6253,6000,12253
6111,VENTURA,2018,56,6091,5978,12069
6111,VENTURA,2018,57,6249,5941,12190
6111,VENTURA,2018,58,6563,6049,12612
6111,VENTURA,2018,59,6265,5694,11959
6111,VENTURA,2018,60,6035,5859,11894
6111,VENTURA,2018,61,5787,5488,11275
6111,VENTURA,2018,62,5669,5389,11058
6111,VENTURA,2018,63,5590,5325,10915
6111,VENTURA,2018,64,5218,4963,10181
6111,VENTURA,2018,65,5195,4656,9851
6111,VENTURA,2018,66,4703,4350,9053
6111,VENTURA,2018,67,4605,4140,8745
6111,VENTURA,2018,68,4570,4128,8698
6111,VENTURA,2018,69,4364,3980,8344
6111,VENTURA,2018,70,4263,3840,8103
6111,VENTURA,2018,71,4245,3812,8057
6111,VENTURA,2018,72,3340,3114,6454
6111,VENTURA,2018,73,3171,2797,5968
6111,VENTURA,2018,74,3053,2734,5787
6111,VENTURA,2018,75,3134,2579,5713
6111,VENTURA,2018,76,2625,2263,4888
6111,VENTURA,2018,77,2414,1984,4398
6111,VENTURA,2018,78,2260,1864,4124
6111,VENTURA,2018,79,2088,1748,3836
6111,VENTURA,2018,80,2038,1616,3654
6111,VENTURA,2018,81,1917,1400,3317
6111,VENTURA,2018,82,1792,1277,3069
6111,VENTURA,2018,83,1646,1229,2875
6111,VENTURA,2018,84,1517,1131,2648
6111,VENTURA,2018,85,1579,1081,2660
6111,VENTURA,2018,86,1436,1038,2474
6111,VENTURA,2018,87,1244,789,2033
6111,VENTURA,2018,88,1206,771,1977
6111,VENTURA,2018,89,1038,602,1640
6111,VENTURA,2018,90,904,534,1438
6111,VENTURA,2018,91,839,429,1268
6111,VENTURA,2018,92,702,346,1048
6111,VENTURA,2018,93,568,209,777
6111,VENTURA,2018,94,425,168,593
6111,VENTURA,2018,95,376,152,528
6111,VENTURA,2018,96,285,86,371
6111,VENTURA,2018,97,193,69,262
6111,VENTURA,2018,98,115,41,156
6111,VENTURA,2018,99,66,26,92
6111,VENTURA,2018,100,118,23,141
6111,VENTURA,2019,0,4634,5005,9639
6111,VENTURA,2019,1,4697,5210,9907
6111,VENTURA,2019,2,4801,5185,9986
6111,VENTURA,2019,3,4800,5171,9971
6111,VENTURA,2019,4,5057,5311,10368
6111,VENTURA,2019,5,5107,5380,10487
6111,VENTURA,2019,6,5235,5398,10633
6111,VENTURA,2019,7,5177,5437,10614
6111,VENTURA,2019,8,5411,5688,11099
6111,VENTURA,2019,9,5250,5431,10681
6111,VENTURA,2019,10,5457,5618,11075
6111,VENTURA,2019,11,5543,5825,11368
6111,VENTURA,2019,12,5705,5808,11513
6111,VENTURA,2019,13,5663,5882,11545
6111,VENTURA,2019,14,5713,5848,11561
6111,VENTURA,2019,15,5693,5887,11580
6111,VENTURA,2019,16,5556,5838,11394
6111,VENTURA,2019,17,5576,5754,11330
6111,VENTURA,2019,18,6223,6428,12651
6111,VENTURA,2019,19,6403,6653,13056
6111,VENTURA,2019,20,5975,6482,12457
6111,VENTURA,2019,21,5817,6170,11987
6111,VENTURA,2019,22,6031,6270,12301
6111,VENTURA,2019,23,6014,6485,12499
6111,VENTURA,2019,24,5764,6266,12030
6111,VENTURA,2019,25,5864,6203,12067
6111,VENTURA,2019,26,5948,6327,12275
6111,VENTURA,2019,27,5510,6099,11609
6111,VENTURA,2019,28,5326,6118,11444
6111,VENTURA,2019,29,5141,5692,10833
6111,VENTURA,2019,30,4945,5466,10411
6111,VENTURA,2019,31,4692,5453,10145
6111,VENTURA,2019,32,4907,5516,10423
6111,VENTURA,2019,33,4927,5529,10456
6111,VENTURA,2019,34,5160,5682,10842
6111,VENTURA,2019,35,5197,5617,10814
6111,VENTURA,2019,36,5232,5575,10807
6111,VENTURA,2019,37,5386,5694,11080
6111,VENTURA,2019,38,5290,5442,10732
6111,VENTURA,2019,39,5305,5814,11119
6111,VENTURA,2019,40,5207,5344,10551
6111,VENTURA,2019,41,5066,5232,10298
6111,VENTURA,2019,42,5033,5061,10094
6111,VENTURA,2019,43,5014,4996,10010
6111,VENTURA,2019,44,5399,5249,10648
6111,VENTURA,2019,45,5171,4951,10122
6111,VENTURA,2019,46,5289,5041,10330
6111,VENTURA,2019,47,5435,5260,10695
6111,VENTURA,2019,48,5690,5552,11242
6111,VENTURA,2019,49,5866,5962,11828
6111,VENTURA,2019,50,5653,5669,11322
6111,VENTURA,2019,51,5465,5455,10920
6111,VENTURA,2019,52,5573,5500,11073
6111,VENTURA,2019,53,5681,5404,11085
6111,VENTURA,2019,54,6090,5867,11957
6111,VENTURA,2019,55,6197,5846,12043
6111,VENTURA,2019,56,6229,5943,12172
6111,VENTURA,2019,57,6065,5967,12032
6111,VENTURA,2019,58,6233,5903,12136
6111,VENTURA,2019,59,6517,5995,12512
6111,VENTURA,2019,60,6244,5645,11889
6111,VENTURA,2019,61,6002,5803,11805
6111,VENTURA,2019,62,5743,5443,11186
6111,VENTURA,2019,63,5635,5337,10972
6111,VENTURA,2019,64,5554,5283,10837
6111,VENTURA,2019,65,5193,4884,10077
6111,VENTURA,2019,66,5158,4610,9768
6111,VENTURA,2019,67,4671,4287,8958
6111,VENTURA,2019,68,4559,4080,8639
6111,VENTURA,2019,69,4527,4074,8601
6111,VENTURA,2019,70,4333,3924,8257
6111,VENTURA,2019,71,4209,3755,7964
6111,VENTURA,2019,72,4181,3739,7920
6111,VENTURA,2019,73,3301,3042,6343
6111,VENTURA,2019,74,3136,2752,5888
6111,VENTURA,2019,75,3033,2684,5717
6111,VENTURA,2019,76,3038,2493,5531
6111,VENTURA,2019,77,2571,2181,4752
6111,VENTURA,2019,78,2353,1929,4282
6111,VENTURA,2019,79,2209,1807,4016
6111,VENTURA,2019,80,2068,1712,3780
6111,VENTURA,2019,81,1968,1516,3484
6111,VENTURA,2019,82,1849,1315,3164
6111,VENTURA,2019,83,1712,1216,2928
6111,VENTURA,2019,84,1584,1157,2741
6111,VENTURA,2019,85,1560,1093,2653
6111,VENTURA,2019,86,1436,990,2426
6111,VENTURA,2019,87,1325,944,2269
6111,VENTURA,2019,88,1160,709,1869
6111,VENTURA,2019,89,1136,709,1845
6111,VENTURA,2019,90,911,543,1454
6111,VENTURA,2019,91,808,431,1239
6111,VENTURA,2019,92,698,331,1029
6111,VENTURA,2019,93,601,277,878
6111,VENTURA,2019,94,479,175,654
6111,VENTURA,2019,95,364,132,496
6111,VENTURA,2019,96,284,104,388
6111,VENTURA,2019,97,208,64,272
6111,VENTURA,2019,98,148,44,192
6111,VENTURA,2019,99,80,31,111
6111,VENTURA,2019,100,129,33,162
6113,YOLO,2017,0,1130,1194,2324
6113,YOLO,2017,1,1140,1218,2358
6113,YOLO,2017,2,1227,1256,2483
6113,YOLO,2017,3,1253,1352,2605
6113,YOLO,2017,4,1358,1407,2765
6113,YOLO,2017,5,1297,1344,2641
6113,YOLO,2017,6,1399,1385,2784
6113,YOLO,2017,7,1434,1381,2815
6113,YOLO,2017,8,1541,1451,2992
6113,YOLO,2017,9,1441,1555,2996
6113,YOLO,2017,10,1558,1585,3143
6113,YOLO,2017,11,1484,1461,2945
6113,YOLO,2017,12,1368,1426,2794
6113,YOLO,2017,13,1458,1335,2793
6113,YOLO,2017,14,1272,1398,2670
6113,YOLO,2017,15,1300,1235,2535
6113,YOLO,2017,16,1279,1296,2575
6113,YOLO,2017,17,1484,1454,2938
6113,YOLO,2017,18,3578,3248,6826
6113,YOLO,2017,19,3106,2924,6030
6113,YOLO,2017,20,4270,4089,8359
6113,YOLO,2017,21,4187,3753,7940
6113,YOLO,2017,22,3390,3268,6658
6113,YOLO,2017,23,2513,2316,4829
6113,YOLO,2017,24,2304,2303,4607
6113,YOLO,2017,25,2223,2105,4328
6113,YOLO,2017,26,1685,1601,3286
6113,YOLO,2017,27,1468,1539,3007
6113,YOLO,2017,28,1453,1471,2924
6113,YOLO,2017,29,1363,1379,2742
6113,YOLO,2017,30,1038,1033,2071
6113,YOLO,2017,31,737,782,1519
6113,YOLO,2017,32,964,1001,1965
6113,YOLO,2017,33,1340,1311,2651
6113,YOLO,2017,34,1298,1283,2581
6113,YOLO,2017,35,1429,1448,2877
6113,YOLO,2017,36,1306,1260,2566
6113,YOLO,2017,37,1312,1334,2646
6113,YOLO,2017,38,1305,1369,2674
6113,YOLO,2017,39,1174,1232,2406
6113,YOLO,2017,40,1236,1224,2460
6113,YOLO,2017,41,1308,1226,2534
6113,YOLO,2017,42,1104,1209,2313
6113,YOLO,2017,43,1142,1135,2277
6113,YOLO,2017,44,1173,1214,2387
6113,YOLO,2017,45,1226,1160,2386
6113,YOLO,2017,46,1227,1229,2456
6113,YOLO,2017,47,1374,1193,2567
6113,YOLO,2017,48,1161,1158,2319
6113,YOLO,2017,49,1205,1164,2369
6113,YOLO,2017,50,1190,1111,2301
6113,YOLO,2017,51,1198,1122,2320
6113,YOLO,2017,52,1210,1172,2382
6113,YOLO,2017,53,1252,1153,2405
6113,YOLO,2017,54,1244,1075,2319
6113,YOLO,2017,55,1219,1170,2389
6113,YOLO,2017,56,1241,1146,2387
6113,YOLO,2017,57,1246,1169,2415
6113,YOLO,2017,58,1177,1043,2220
6113,YOLO,2017,59,1241,1074,2315
6113,YOLO,2017,60,1180,1082,2262
6113,YOLO,2017,61,1133,1067,2200
6113,YOLO,2017,62,1181,1041,2222
6113,YOLO,2017,63,1130,1005,2135
6113,YOLO,2017,64,1098,1019,2117
6113,YOLO,2017,65,1057,932,1989
6113,YOLO,2017,66,966,858,1824
6113,YOLO,2017,67,965,882,1847
6113,YOLO,2017,68,917,813,1730
6113,YOLO,2017,69,883,831,1714
6113,YOLO,2017,70,900,785,1685
6113,YOLO,2017,71,738,580,1318
6113,YOLO,2017,72,693,572,1265
6113,YOLO,2017,73,682,556,1238
6113,YOLO,2017,74,644,506,1150
6113,YOLO,2017,75,598,526,1124
6113,YOLO,2017,76,543,478,1021
6113,YOLO,2017,77,475,457,932
6113,YOLO,2017,78,459,405,864
6113,YOLO,2017,79,458,338,796
6113,YOLO,2017,80,439,345,784
6113,YOLO,2017,81,411,293,704
6113,YOLO,2017,82,329,262,591
6113,YOLO,2017,83,294,246,540
6113,YOLO,2017,84,315,201,516
6113,YOLO,2017,85,313,204,517
6113,YOLO,2017,86,320,198,518
6113,YOLO,2017,87,248,154,402
6113,YOLO,2017,88,195,120,315
6113,YOLO,2017,89,206,132,338
6113,YOLO,2017,90,197,78,275
6113,YOLO,2017,91,178,71,249
6113,YOLO,2017,92,131,53,184
6113,YOLO,2017,93,130,42,172
6113,YOLO,2017,94,98,47,145
6113,YOLO,2017,95,92,23,115
6113,YOLO,2017,96,42,21,63
6113,YOLO,2017,97,41,10,51
6113,YOLO,2017,98,16,9,25
6113,YOLO,2017,99,25,7,32
6113,YOLO,2017,100,25,8,33
6113,YOLO,2018,0,1095,1317,2412
6113,YOLO,2018,1,1124,1189,2313
6113,YOLO,2018,2,1203,1268,2471
6113,YOLO,2018,3,1258,1300,2558
6113,YOLO,2018,4,1297,1428,2725
6113,YOLO,2018,5,1430,1431,2861
6113,YOLO,2018,6,1326,1379,2705
6113,YOLO,2018,7,1489,1420,2909
6113,YOLO,2018,8,1470,1445,2915
6113,YOLO,2018,9,1577,1472,3049
6113,YOLO,2018,10,1471,1586,3057
6113,YOLO,2018,11,1591,1600,3191
6113,YOLO,2018,12,1491,1483,2974
6113,YOLO,2018,13,1379,1437,2816
6113,YOLO,2018,14,1465,1330,2795
6113,YOLO,2018,15,1308,1404,2712
6113,YOLO,2018,16,1309,1257,2566
6113,YOLO,2018,17,1463,1448,2911
6113,YOLO,2018,18,3677,3200,6877
6113,YOLO,2018,19,3123,3016,6139
6113,YOLO,2018,20,4180,4004,8184
6113,YOLO,2018,21,4165,3814,7979
6113,YOLO,2018,22,3669,3412,7081
6113,YOLO,2018,23,2709,2597,5306
6113,YOLO,2018,24,2246,2354,4600
6113,YOLO,2018,25,1859,1798,3657
6113,YOLO,2018,26,1714,1594,3308
6113,YOLO,2018,27,1771,1655,3426
6113,YOLO,2018,28,1356,1430,2786
6113,YOLO,2018,29,1515,1525,3040
6113,YOLO,2018,30,1257,1248,2505
6113,YOLO,2018,31,977,1039,2016
6113,YOLO,2018,32,813,859,1672
6113,YOLO,2018,33,945,1000,1945
6113,YOLO,2018,34,1324,1275,2599
6113,YOLO,2018,35,1428,1387,2815
6113,YOLO,2018,36,1312,1354,2666
6113,YOLO,2018,37,1311,1267,2578
6113,YOLO,2018,38,1318,1344,2662
6113,YOLO,2018,39,1299,1381,2680
6113,YOLO,2018,40,1182,1228,2410
6113,YOLO,2018,41,1251,1247,2498
6113,YOLO,2018,42,1317,1236,2553
6113,YOLO,2018,43,1115,1218,2333
6113,YOLO,2018,44,1147,1155,2302
6113,YOLO,2018,45,1193,1194,2387
6113,YOLO,2018,46,1226,1160,2386
6113,YOLO,2018,47,1226,1226,2452
6113,YOLO,2018,48,1373,1197,2570
6113,YOLO,2018,49,1167,1155,2322
6113,YOLO,2018,50,1193,1159,2352
6113,YOLO,2018,51,1192,1106,2298
6113,YOLO,2018,52,1193,1113,2306
6113,YOLO,2018,53,1210,1167,2377
6113,YOLO,2018,54,1240,1133,2373
6113,YOLO,2018,55,1236,1078,2314
6113,YOLO,2018,56,1211,1168,2379
6113,YOLO,2018,57,1234,1128,2362
6113,YOLO,2018,58,1243,1155,2398
6113,YOLO,2018,59,1157,1025,2182
6113,YOLO,2018,60,1247,1063,2310
6113,YOLO,2018,61,1157,1082,2239
6113,YOLO,2018,62,1128,1047,2175
6113,YOLO,2018,63,1172,1027,2199
6113,YOLO,2018,64,1115,1012,2127
6113,YOLO,2018,65,1088,1001,2089
6113,YOLO,2018,66,1047,917,1964
6113,YOLO,2018,67,958,857,1815
6113,YOLO,2018,68,961,870,1831
6113,YOLO,2018,69,919,802,1721
6113,YOLO,2018,70,879,817,1696
6113,YOLO,2018,71,877,780,1657
6113,YOLO,2018,72,740,572,1312
6113,YOLO,2018,73,694,561,1255
6113,YOLO,2018,74,685,566,1251
6113,YOLO,2018,75,631,513,1144
6113,YOLO,2018,76,593,516,1109
6113,YOLO,2018,77,538,460,998
6113,YOLO,2018,78,457,442,899
6113,YOLO,2018,79,455,406,861
6113,YOLO,2018,80,461,329,790
6113,YOLO,2018,81,405,321,726
6113,YOLO,2018,82,392,269,661
6113,YOLO,2018,83,321,260,581
6113,YOLO,2018,84,289,219,508
6113,YOLO,2018,85,325,190,515
6113,YOLO,2018,86,285,192,477
6113,YOLO,2018,87,296,179,475
6113,YOLO,2018,88,234,145,379
6113,YOLO,2018,89,175,109,284
6113,YOLO,2018,90,183,119,302
6113,YOLO,2018,91,166,68,234
6113,YOLO,2018,92,160,52,212
6113,YOLO,2018,93,118,38,156
6113,YOLO,2018,94,109,35,144
6113,YOLO,2018,95,68,35,103
6113,YOLO,2018,96,69,16,85
6113,YOLO,2018,97,29,18,47
6113,YOLO,2018,98,33,6,39
6113,YOLO,2018,99,12,11,23
6113,YOLO,2018,100,33,7,40
6113,YOLO,2019,0,1140,1195,2335
6113,YOLO,2019,1,1093,1309,2402
6113,YOLO,2019,2,1179,1243,2422
6113,YOLO,2019,3,1232,1313,2545
6113,YOLO,2019,4,1315,1355,2670
6113,YOLO,2019,5,1362,1472,2834
6113,YOLO,2019,6,1460,1449,2909
6113,YOLO,2019,7,1435,1408,2843
6113,YOLO,2019,8,1534,1486,3020
6113,YOLO,2019,9,1495,1467,2962
6113,YOLO,2019,10,1610,1499,3109
6113,YOLO,2019,11,1493,1597,3090
6113,YOLO,2019,12,1593,1626,3219
6113,YOLO,2019,13,1503,1497,3000
6113,YOLO,2019,14,1386,1443,2829
6113,YOLO,2019,15,1499,1335,2834
6113,YOLO,2019,16,1316,1426,2742
6113,YOLO,2019,17,1495,1410,2905
6113,YOLO,2019,18,3644,3197,6841
6113,YOLO,2019,19,3231,2976,6207
6113,YOLO,2019,20,4184,4099,8283
6113,YOLO,2019,21,4074,3730,7804
6113,YOLO,2019,22,3644,3475,7119
6113,YOLO,2019,23,2989,2741,5730
6113,YOLO,2019,24,2445,2638,5083
6113,YOLO,2019,25,1803,1847,3650
6113,YOLO,2019,26,1350,1289,2639
6113,YOLO,2019,27,1803,1648,3451
6113,YOLO,2019,28,1659,1543,3202
6113,YOLO,2019,29,1419,1484,2903
6113,YOLO,2019,30,1410,1394,2804
6113,YOLO,2019,31,1200,1232,2432
6113,YOLO,2019,32,1064,1125,2189
6113,YOLO,2019,33,801,835,1636
6113,YOLO,2019,34,952,962,1914
6113,YOLO,2019,35,1444,1382,2826
6113,YOLO,2019,36,1313,1290,2603
6113,YOLO,2019,37,1316,1358,2674
6113,YOLO,2019,38,1322,1282,2604
6113,YOLO,2019,39,1317,1353,2670
6113,YOLO,2019,40,1306,1378,2684
6113,YOLO,2019,41,1198,1251,2449
6113,YOLO,2019,42,1248,1256,2504
6113,YOLO,2019,43,1326,1250,2576
6113,YOLO,2019,44,1125,1241,2366
6113,YOLO,2019,45,1172,1136,2308
6113,YOLO,2019,46,1190,1192,2382
6113,YOLO,2019,47,1227,1158,2385
6113,YOLO,2019,48,1223,1227,2450
6113,YOLO,2019,49,1379,1189,2568
6113,YOLO,2019,50,1153,1154,2307
6113,YOLO,2019,51,1192,1162,2354
6113,YOLO,2019,52,1190,1094,2284
6113,YOLO,2019,53,1198,1112,2310
6113,YOLO,2019,54,1202,1148,2350
6113,YOLO,2019,55,1233,1130,2363
6113,YOLO,2019,56,1225,1080,2305
6113,YOLO,2019,57,1196,1146,2342
6113,YOLO,2019,58,1239,1111,2350
6113,YOLO,2019,59,1224,1135,2359
6113,YOLO,2019,60,1167,1008,2175
6113,YOLO,2019,61,1222,1060,2282
6113,YOLO,2019,62,1151,1070,2221
6113,YOLO,2019,63,1128,1031,2159
6113,YOLO,2019,64,1159,1025,2184
6113,YOLO,2019,65,1100,987,2087
6113,YOLO,2019,66,1085,979,2064
6113,YOLO,2019,67,1035,906,1941
6113,YOLO,2019,68,957,849,1806
6113,YOLO,2019,69,963,852,1815
6113,YOLO,2019,70,907,785,1692
6113,YOLO,2019,71,872,802,1674
6113,YOLO,2019,72,881,772,1653
6113,YOLO,2019,73,729,560,1289
6113,YOLO,2019,74,697,565,1262
6113,YOLO,2019,75,678,576,1254
6113,YOLO,2019,76,623,495,1118
6113,YOLO,2019,77,595,490,1085
6113,YOLO,2019,78,508,430,938
6113,YOLO,2019,79,445,438,883
6113,YOLO,2019,80,455,396,851
6113,YOLO,2019,81,429,306,735
6113,YOLO,2019,82,393,315,708
6113,YOLO,2019,83,375,261,636
6113,YOLO,2019,84,317,235,552
6113,YOLO,2019,85,302,209,511
6113,YOLO,2019,86,296,183,479
6113,YOLO,2019,87,271,168,439
6113,YOLO,2019,88,279,167,446
6113,YOLO,2019,89,206,126,332
6113,YOLO,2019,90,159,96,255
6113,YOLO,2019,91,166,96,262
6113,YOLO,2019,92,147,59,206
6113,YOLO,2019,93,143,38,181
6113,YOLO,2019,94,97,28,125
6113,YOLO,2019,95,86,29,115
6113,YOLO,2019,96,50,23,73
6113,YOLO,2019,97,58,15,73
6113,YOLO,2019,98,24,8,32
6113,YOLO,2019,99,23,4,27
6113,YOLO,2019,100,31,9,40
6115,YUBA,2017,0,535,634,1169
6115,YUBA,2017,1,567,588,1155
6115,YUBA,2017,2,557,616,1173
6115,YUBA,2017,3,597,591,1188
6115,YUBA,2017,4,589,627,1216
6115,YUBA,2017,5,577,635,1212
6115,YUBA,2017,6,598,642,1240
6115,YUBA,2017,7,570,599,1169
6115,YUBA,2017,8,600,656,1256
6115,YUBA,2017,9,596,648,1244
6115,YUBA,2017,10,581,663,1244
6115,YUBA,2017,11,635,603,1238
6115,YUBA,2017,12,577,618,1195
6115,YUBA,2017,13,556,631,1187
6115,YUBA,2017,14,577,634,1211
6115,YUBA,2017,15,520,586,1106
6115,YUBA,2017,16,529,655,1184
6115,YUBA,2017,17,542,573,1115
6115,YUBA,2017,18,507,579,1086
6115,YUBA,2017,19,529,550,1079
6115,YUBA,2017,20,523,639,1162
6115,YUBA,2017,21,568,632,1200
6115,YUBA,2017,22,586,567,1153
6115,YUBA,2017,23,551,637,1188
6115,YUBA,2017,24,564,628,1192
6115,YUBA,2017,25,512,578,1090
6115,YUBA,2017,26,507,542,1049
6115,YUBA,2017,27,515,547,1062
6115,YUBA,2017,28,505,517,1022
6115,YUBA,2017,29,537,525,1062
6115,YUBA,2017,30,523,500,1023
6115,YUBA,2017,31,558,537,1095
6115,YUBA,2017,32,549,529,1078
6115,YUBA,2017,33,505,573,1078
6115,YUBA,2017,34,551,557,1108
6115,YUBA,2017,35,510,487,997
6115,YUBA,2017,36,544,479,1023
6115,YUBA,2017,37,540,510,1050
6115,YUBA,2017,38,495,515,1010
6115,YUBA,2017,39,512,469,981
6115,YUBA,2017,40,461,510,971
6115,YUBA,2017,41,451,482,933
6115,YUBA,2017,42,425,470,895
6115,YUBA,2017,43,461,426,887
6115,YUBA,2017,44,396,424,820
6115,YUBA,2017,45,419,413,832
6115,YUBA,2017,46,457,442,899
6115,YUBA,2017,47,445,428,873
6115,YUBA,2017,48,449,452,901
6115,YUBA,2017,49,432,441,873
6115,YUBA,2017,50,416,416,832
6115,YUBA,2017,51,469,459,928
6115,YUBA,2017,52,415,492,907
6115,YUBA,2017,53,446,477,923
6115,YUBA,2017,54,490,478,968
6115,YUBA,2017,55,453,452,905
6115,YUBA,2017,56,461,468,929
6115,YUBA,2017,57,516,439,955
6115,YUBA,2017,58,446,435,881
6115,YUBA,2017,59,470,441,911
6115,YUBA,2017,60,435,437,872
6115,YUBA,2017,61,443,425,868
6115,YUBA,2017,62,440,406,846
6115,YUBA,2017,63,440,410,850
6115,YUBA,2017,64,373,377,750
6115,YUBA,2017,65,331,330,661
6115,YUBA,2017,66,364,331,695
6115,YUBA,2017,67,331,328,659
6115,YUBA,2017,68,348,326,674
6115,YUBA,2017,69,366,310,676
6115,YUBA,2017,70,306,310,616
6115,YUBA,2017,71,249,212,461
6115,YUBA,2017,72,216,178,394
6115,YUBA,2017,73,273,172,445
6115,YUBA,2017,74,204,196,400
6115,YUBA,2017,75,205,183,388
6115,YUBA,2017,76,175,182,357
6115,YUBA,2017,77,189,182,371
6115,YUBA,2017,78,138,127,265
6115,YUBA,2017,79,182,123,305
6115,YUBA,2017,80,126,108,234
6115,YUBA,2017,81,152,107,259
6115,YUBA,2017,82,105,112,217
6115,YUBA,2017,83,117,95,212
6115,YUBA,2017,84,90,78,168
6115,YUBA,2017,85,67,78,145
6115,YUBA,2017,86,85,71,156
6115,YUBA,2017,87,70,47,117
6115,YUBA,2017,88,58,34,92
6115,YUBA,2017,89,55,28,83
6115,YUBA,2017,90,62,34,96
6115,YUBA,2017,91,42,16,58
6115,YUBA,2017,92,27,21,48
6115,YUBA,2017,93,32,17,49
6115,YUBA,2017,94,22,11,33
6115,YUBA,2017,95,12,15,27
6115,YUBA,2017,96,6,5,11
6115,YUBA,2017,97,6,3,9
6115,YUBA,2017,98,13,1,14
6115,YUBA,2017,99,3,3,6
6115,YUBA,2017,100,1,3,4
6115,YUBA,2018,0,568,597,1165
6115,YUBA,2018,1,532,630,1162
6115,YUBA,2018,2,566,588,1154
6115,YUBA,2018,3,557,616,1173
6115,YUBA,2018,4,597,591,1188
6115,YUBA,2018,5,587,630,1217
6115,YUBA,2018,6,576,632,1208
6115,YUBA,2018,7,598,645,1243
6115,YUBA,2018,8,570,595,1165
6115,YUBA,2018,9,598,656,1254
6115,YUBA,2018,10,596,650,1246
6115,YUBA,2018,11,578,662,1240
6115,YUBA,2018,12,634,603,1237
6115,YUBA,2018,13,573,610,1183
6115,YUBA,2018,14,553,630,1183
6115,YUBA,2018,15,573,629,1202
6115,YUBA,2018,16,518,655,1173
6115,YUBA,2018,17,516,578,1094
6115,YUBA,2018,18,533,565,1098
6115,YUBA,2018,19,511,595,1106
6115,YUBA,2018,20,533,591,1124
6115,YUBA,2018,21,521,646,1167
6115,YUBA,2018,22,573,620,1193
6115,YUBA,2018,23,591,569,1160
6115,YUBA,2018,24,541,651,1192
6115,YUBA,2018,25,559,569,1128
6115,YUBA,2018,26,518,590,1108
6115,YUBA,2018,27,514,551,1065
6115,YUBA,2018,28,539,560,1099
6115,YUBA,2018,29,505,534,1039
6115,YUBA,2018,30,552,537,1089
6115,YUBA,2018,31,527,506,1033
6115,YUBA,2018,32,562,534,1096
6115,YUBA,2018,33,552,530,1082
6115,YUBA,2018,34,508,581,1089
6115,YUBA,2018,35,559,557,1116
6115,YUBA,2018,36,512,480,992
6115,YUBA,2018,37,542,483,1025
6115,YUBA,2018,38,538,503,1041
6115,YUBA,2018,39,492,515,1007
6115,YUBA,2018,40,511,475,986
6115,YUBA,2018,41,464,509,973
6115,YUBA,2018,42,449,484,933
6115,YUBA,2018,43,419,461,880
6115,YUBA,2018,44,459,429,888
6115,YUBA,2018,45,397,409,806
6115,YUBA,2018,46,426,413,839
6115,YUBA,2018,47,459,443,902
6115,YUBA,2018,48,443,423,866
6115,YUBA,2018,49,456,453,909
6115,YUBA,2018,50,433,436,869
6115,YUBA,2018,51,432,418,850
6115,YUBA,2018,52,467,463,930
6115,YUBA,2018,53,424,495,919
6115,YUBA,2018,54,457,461,918
6115,YUBA,2018,55,488,483,971
6115,YUBA,2018,56,451,455,906
6115,YUBA,2018,57,462,467,929
6115,YUBA,2018,58,514,440,954
6115,YUBA,2018,59,440,437,877
6115,YUBA,2018,60,464,421,885
6115,YUBA,2018,61,436,432,868
6115,YUBA,2018,62,440,422,862
6115,YUBA,2018,63,434,399,833
6115,YUBA,2018,64,439,401,840
6115,YUBA,2018,65,367,375,742
6115,YUBA,2018,66,328,326,654
6115,YUBA,2018,67,356,322,678
6115,YUBA,2018,68,323,323,646
6115,YUBA,2018,69,347,323,670
6115,YUBA,2018,70,356,306,662
6115,YUBA,2018,71,300,299,599
6115,YUBA,2018,72,244,209,453
6115,YUBA,2018,73,211,170,381
6115,YUBA,2018,74,269,162,431
6115,YUBA,2018,75,203,187,390
6115,YUBA,2018,76,201,175,376
6115,YUBA,2018,77,171,170,341
6115,YUBA,2018,78,180,175,355
6115,YUBA,2018,79,138,120,258
6115,YUBA,2018,80,171,118,289
6115,YUBA,2018,81,119,101,220
6115,YUBA,2018,82,138,97,235
6115,YUBA,2018,83,108,103,211
6115,YUBA,2018,84,110,91,201
6115,YUBA,2018,85,87,73,160
6115,YUBA,2018,86,58,72,130
6115,YUBA,2018,87,79,63,142
6115,YUBA,2018,88,64,42,106
6115,YUBA,2018,89,54,32,86
6115,YUBA,2018,90,47,24,71
6115,YUBA,2018,91,54,26,80
6115,YUBA,2018,92,37,13,50
6115,YUBA,2018,93,23,16,39
6115,YUBA,2018,94,26,13,39
6115,YUBA,2018,95,21,11,32
6115,YUBA,2018,96,8,7,15
6115,YUBA,2018,97,3,4,7
6115,YUBA,2018,98,6,1,7
6115,YUBA,2018,99,9,1,10
6115,YUBA,2018,100,3,5,8
6115,YUBA,2019,0,572,592,1164
6115,YUBA,2019,1,565,595,1160
6115,YUBA,2019,2,531,630,1161
6115,YUBA,2019,3,566,588,1154
6115,YUBA,2019,4,556,616,1172
6115,YUBA,2019,5,597,593,1190
6115,YUBA,2019,6,587,625,1212
6115,YUBA,2019,7,576,633,1209
6115,YUBA,2019,8,598,642,1240
6115,YUBA,2019,9,570,595,1165
6115,YUBA,2019,10,598,658,1256
6115,YUBA,2019,11,594,645,1239
6115,YUBA,2019,12,576,663,1239
6115,YUBA,2019,13,628,597,1225
6115,YUBA,2019,14,572,610,1182
6115,YUBA,2019,15,548,627,1175
6115,YUBA,2019,16,580,697,1277
6115,YUBA,2019,17,503,584,1087
6115,YUBA,2019,18,510,567,1077
6115,YUBA,2019,19,531,587,1118
6115,YUBA,2019,20,513,626,1139
6115,YUBA,2019,21,529,604,1133
6115,YUBA,2019,22,525,630,1155
6115,YUBA,2019,23,577,627,1204
6115,YUBA,2019,24,582,584,1166
6115,YUBA,2019,25,534,595,1129
6115,YUBA,2019,26,574,585,1159
6115,YUBA,2019,27,526,603,1129
6115,YUBA,2019,28,529,567,1096
6115,YUBA,2019,29,538,569,1107
6115,YUBA,2019,30,521,544,1065
6115,YUBA,2019,31,557,540,1097
6115,YUBA,2019,32,533,503,1036
6115,YUBA,2019,33,566,539,1105
6115,YUBA,2019,34,554,541,1095
6115,YUBA,2019,35,507,579,1086
6115,YUBA,2019,36,561,549,1110
6115,YUBA,2019,37,509,484,993
6115,YUBA,2019,38,542,476,1018
6115,YUBA,2019,39,536,504,1040
6115,YUBA,2019,40,491,519,1010
6115,YUBA,2019,41,515,473,988
6115,YUBA,2019,42,462,513,975
6115,YUBA,2019,43,444,476,920
6115,YUBA,2019,44,419,465,884
6115,YUBA,2019,45,460,411,871
6115,YUBA,2019,46,397,411,808
6115,YUBA,2019,47,426,414,840
6115,YUBA,2019,48,456,444,900
6115,YUBA,2019,49,449,420,869
6115,YUBA,2019,50,459,457,916
6115,YUBA,2019,51,443,439,882
6115,YUBA,2019,52,425,420,845
6115,YUBA,2019,53,478,470,948
6115,YUBA,2019,54,439,488,927
6115,YUBA,2019,55,453,474,927
6115,YUBA,2019,56,482,482,964
6115,YUBA,2019,57,448,448,896
6115,YUBA,2019,58,463,467,930
6115,YUBA,2019,59,512,441,953
6115,YUBA,2019,60,438,423,861
6115,YUBA,2019,61,463,415,878
6115,YUBA,2019,62,431,432,863
6115,YUBA,2019,63,440,416,856
6115,YUBA,2019,64,433,384,817
6115,YUBA,2019,65,432,397,829
6115,YUBA,2019,66,365,365,730
6115,YUBA,2019,67,320,320,640
6115,YUBA,2019,68,350,310,660
6115,YUBA,2019,69,320,315,635
6115,YUBA,2019,70,339,326,665
6115,YUBA,2019,71,351,292,643
6115,YUBA,2019,72,298,288,586
6115,YUBA,2019,73,237,201,438
6115,YUBA,2019,74,204,164,368
6115,YUBA,2019,75,264,158,422
6115,YUBA,2019,76,198,179,377
6115,YUBA,2019,77,196,166,362
6115,YUBA,2019,78,164,156,320
6115,YUBA,2019,79,177,165,342
6115,YUBA,2019,80,131,116,247
6115,YUBA,2019,81,162,108,270
6115,YUBA,2019,82,109,97,206
6115,YUBA,2019,83,134,92,226
6115,YUBA,2019,84,102,99,201
6115,YUBA,2019,85,103,87,190
6115,YUBA,2019,86,73,75,148
6115,YUBA,2019,87,51,62,113
6115,YUBA,2019,88,69,61,130
6115,YUBA,2019,89,57,34,91
6115,YUBA,2019,90,46,25,71
6115,YUBA,2019,91,41,18,59
6115,YUBA,2019,92,49,22,71
6115,YUBA,2019,93,31,10,41
6115,YUBA,2019,94,22,13,35
6115,YUBA,2019,95,24,7,31
6115,YUBA,2019,96,14,10,24
6115,YUBA,2019,97,7,3,10
6115,YUBA,2019,98,3,3,6
6115,YUBA,2019,99,3,1,4
6115,YUBA,2019,100,9,5,14
